"","Player","Team","Position","GP","TOI","Goals","Total Assists","First Assists","Second Assists","Total Points","IPP"
"279","Nathan MacKinnon","COL","C","71","1189.7333333333","25","40","30","10","65","80.25"
"67","Erik Karlsson","S.J","D","82","1667.8","16","48","29","19","64","66.67"
"320","David Pastrnak","BOS","R","82","1185.8333333333","34","27","14","13","61","83.56"
"331","Brayden Point","T.B","C","82","1203.25","29","30","16","14","59","79.73"
"356","Connor McDavid","EDM","C","82","1308.2666666667","32","27","20","7","59","78.67"
"414","Matthew Tkachuk","FLA","L","79","1120.9333333333","22","36","22","14","58","65.17"
"140","Jeff Skinner","BUF","L","79","1071.8833333333","25","31","19","12","56","70.00"
"486","Elias Pettersson","VAN","C","80","1100.6","21","35","20","15","56","86.15"
"493","Jason Robertson","DAL","L","82","1186.4833333333","26","30","19","11","56","78.87"
"588","Jack Hughes","N.J","C","78","1201.7666666667","28","28","18","10","56","78.87"
"17","Sidney Crosby","PIT","C","82","1240.9166666667","22","33","19","14","55","82.09"
"449","Tage Thompson","BUF","C, R","78","1066.8166666667","25","30","20","10","55","80.88"
"362","Mikko Rantanen","COL","R","82","1357.7333333333","32","21","14","7","53","70.67"
"385","Mitchell Marner","TOR","R","80","1143.8833333333","15","38","28","10","53","82.81"
"425","Clayton Keller","ARI","R","82","1290.8333333333","24","29","23","6","53","81.54"
"261","Carter Verhaeghe","FLA","C","81","1148.1833333333","28","24","11","13","52","76.47"
"415","Auston Matthews","TOR","C","74","1145.7833333333","26","26","19","7","52","69.33"
"179","Nikita Kucherov","T.B","R","82","1226.7666666667","15","36","20","16","51","70.83"
"306","Leon Draisaitl","EDM","C","80","1269.7166666667","17","34","29","5","51","68.92"
"394","Artemi Panarin","NYR","L","82","1224.2","19","31","19","12","50","79.37"
"308","William Nylander","TOR","R","82","1124.75","22","27","13","14","49","76.56"
"633","Andrei Kuzmenko","VAN","L","81","1023.7333333333","21","28","11","17","49","76.56"
"132","Brock Nelson","NYI","C","82","1128.8333333333","24","24","14","10","48","67.61"
"141","Zach Hyman","EDM","L","79","1216.05","15","33","20","13","48","60.76"
"315","Alex Tuch","BUF","R","74","999.3","21","27","19","8","48","72.73"
"319","Jared McCann","SEA","L","79","968.98333333333","30","18","14","4","48","71.64"
"19","Anze Kopitar","L.A","C","82","1166.9333333333","17","29","16","13","46","76.67"
"615","Tim Stützle","OTT","L","78","1157.55","20","26","15","11","46","74.19"
"481","Nico Hischier","N.J","C","81","1067.5333333333","14","31","21","10","45","73.77"
"537","Brady Tkachuk","OTT","L","82","1105.7166666667","20","25","15","10","45","75.00"
"11","Evgeni Malkin","PIT","C","82","1123.8","15","29","20","9","44","83.02"
"68","Jordan Eberle","SEA","R","82","1105.75","16","28","21","7","44","66.67"
"224","Chandler Stephenson","VGK","C","81","1128.7166666667","7","37","22","15","44","74.58"
"355","Pavel Zacha","BOS","C","82","1022.8666666667","15","28","12","16","43","66.15"
"374","Roope Hintz","DAL","C","73","929.48333333333","21","22","16","6","43","74.14"
"445","Jesper Bratt","N.J","L","82","1110.9166666667","20","23","14","9","43","68.25"
"34","Claude Giroux","OTT","R","82","1138.7333333333","23","19","14","5","42","73.68"
"352","Kyle Connor","WPG","L","82","1246.7","20","22","14","8","42","70.00"
"358","Vince Dunn","SEA","D","81","1551.5833333333","13","29","12","17","42","40.78"
"439","Jordan Kyrou","STL","C","79","1118.7","22","20","12","8","42","75.00"
"40","Alex Killorn","T.B","L","82","1023.55","19","22","11","11","41","70.69"
"41","Jamie Benn","DAL","L","82","909.55","17","24","11","13","41","69.49"
"61","Steven Stamkos","T.B","C","81","1113.25","16","25","16","9","41","65.08"
"91","Brayden Schenn","STL","C","82","1155.8166666667","12","29","16","13","41","80.39"
"405","Troy Terry","ANA","R","70","1073.3166666667","13","28","16","12","41","75.93"
"489","Nick Suzuki","MTL","C","82","1213.5166666667","14","27","15","12","41","64.06"
"582","Trevor Zegras","ANA","C","81","1217.8666666667","16","25","18","7","41","71.93"
"8","Joe Pavelski","DAL","C","82","1111.45","12","28","17","11","40","56.34"
"10","Alex Ovechkin","WSH","L","73","1041.0833333333","20","20","11","9","40","75.47"
"14","David Krejci","BOS","C","70","941.06666666667","12","28","19","9","40","68.97"
"125","Tyler Toffoli","CGY","R","82","996.06666666667","19","21","8","13","40","68.97"
"165","Vincent Trocheck","NYR","C","82","1205.5666666667","10","30","21","9","40","72.73"
"184","Mika Zibanejad","NYR","C","82","1093.9","16","24","17","7","40","78.43"
"289","Josh Morrissey","WPG","D","78","1473.35","12","28","19","9","40","53.33"
"624","Matty Beniers","SEA","C","80","1086.8","17","23","12","11","40","63.49"
"162","Johnny Gaudreau","CBJ","L","80","1204.6666666667","13","26","15","11","39","72.22"
"180","Ryan Nugent-Hopkins","EDM","C","82","1093.2333333333","16","23","11","12","39","61.90"
"185","Mark Scheifele","WPG","C","81","1261.2333333333","25","14","7","7","39","69.64"
"311","Kevin Fiala","L.A","L","69","940.51666666667","9","30","19","11","39","76.47"
"357","Jack Eichel","VGK","C","67","956.16666666667","20","19","10","9","39","69.64"
"370","Dylan Strome","WSH","C","81","1036.4833333333","17","22","11","11","39","69.64"
"480","Casey Mittelstadt","BUF","C","82","1035.65","9","30","21","9","39","72.22"
"581","Dylan Cozens","BUF","C","81","949.18333333333","21","18","13","5","39","76.47"
"286","Bo Horvat","NYI, VAN","C","79","1152.5833333333","19","19","13","6","38","71.70"
"317","Nick Schmaltz","ARI","C","63","940.76666666667","15","23","11","12","38","73.08"
"458","Brandon Hagel","T.B","L","81","1112.2166666667","17","21","10","11","38","64.41"
"87","John Tavares","TOR","C","80","1062.3666666667","16","21","11","10","37","71.15"
"93","Nazem Kadri","CGY","C","82","1082.65","13","24","14","10","37","69.81"
"124","Jason Zucker","PIT","L","78","1077.0333333333","24","13","7","6","37","68.52"
"203","Yanni Gourde","SEA","C","81","1129.7333333333","7","30","16","14","37","62.71"
"258","Pavel Buchnevich","STL","L","63","865.45","18","19","14","5","37","69.81"
"259","Jake Guentzel","PIT","L","78","1186.1666666667","16","21","16","5","37","62.71"
"364","Sebastian Aho","CAR","C","75","999.83333333333","22","15","13","2","37","69.81"
"428","Dillon Dube","CGY","C","82","994.26666666667","13","24","12","12","37","72.55"
"612","Dawson Mercer","N.J","C","82","1089.3666666667","20","17","12","5","37","67.27"
"49","Logan Couture","S.J","C","82","1042.0333333333","14","22","13","9","36","70.59"
"55","Mikael Backlund","CGY","C","82","1090.5","13","23","14","9","36","66.67"
"181","Jonathan Huberdeau","CGY","C","79","1029.4833333333","10","26","16","10","36","72.00"
"186","Dougie Hamilton","N.J","D","82","1422.55","13","23","11","12","36","44.44"
"280","Aleksander Barkov","FLA","C","68","911.61666666667","12","24","13","11","36","67.92"
"323","Ivan Barbashev","STL, VGK","C","82","1122.6833333333","12","24","12","12","36","67.92"
"338","Michael Bunting","TOR","L","82","1112.8333333333","14","22","16","6","36","55.38"
"360","Timo Meier","N.J, S.J","R","78","1181.95","22","14","9","5","36","60.00"
"494","Morgan Frost","PHI","C","81","1071.65","16","20","9","11","36","76.60"
"101","Tomas Tatar","N.J","L","82","1069.2333333333","15","20","7","13","35","57.38"
"196","Rickard Rakell","PIT","R","82","1199.9833333333","16","19","6","13","35","57.38"
"283","Elias Lindholm","CGY","C","80","994.28333333333","10","25","15","10","35","67.31"
"348","Andrew Mangiapane","CGY","L","82","1067.5333333333","15","20","13","7","35","60.34"
"372","Brock Boeser","VAN","R","74","998.36666666667","10","25","13","12","35","66.04"
"491","Robert Thomas","STL","C","73","1022.8","9","26","17","9","35","60.34"
"498","Martin Necas","CAR","C","82","1136.9833333333","13","22","19","3","35","58.33"
"506","Filip Chytil","NYR","C","74","934.7","17","18","13","5","35","72.92"
"534","Joel Farabee","PHI","L","82","1094.95","15","20","9","11","35","64.81"
"89","Matt Duchene","NSH","C","71","1000.15","12","22","11","11","34","66.67"
"100","Reilly Smith","VGK","R","78","988.1","11","23","14","9","34","72.34"
"127","Charlie Coyle","BOS","C","82","1070.1166666667","15","19","10","9","34","66.67"
"198","Jonathan Marchessault","VGK","C, R","76","1050.6666666667","16","18","11","7","34","70.83"
"262","Oliver Bjorkstrand","SEA","R","81","1046.85","15","19","10","9","34","69.39"
"321","Adrian Kempe","L.A","C, R","82","1100.05","22","12","8","4","34","68.00"
"334","Devon Toews","COL","D","80","1498.8166666667","6","28","10","18","34","43.04"
"417","Adam Fox","NYR","D","82","1435.05","8","26","12","14","34","49.28"
"514","Eetu Luostarinen","FLA","C","82","1011.8833333333","15","19","7","12","34","60.71"
"52","Patrick Kane","CHI, NYR","R","73","1097.4333333333","16","17","10","7","33","67.35"
"131","Justin Faulk","STL","D","82","1487.05","7","26","14","12","33","44.00"
"177","William Karlsson","VGK","C","82","1075","8","25","10","15","33","70.21"
"215","Tomas Hertl","S.J","C","79","1169.2833333333","13","20","10","10","33","62.26"
"327","Brandon Montour","FLA","D","80","1416.9","11","22","11","11","33","39.76"
"384","Lawson Crouse","ARI","L","77","1003.75","14","19","12","7","33","67.35"
"386","Joel Eriksson Ek","MIN","C","78","951.61666666667","7","26","16","10","33","84.62"
"404","Kirill Kaprizov","MIN","L","67","1039.0333333333","18","15","9","6","33","75.00"
"446","Mikhail Sergachev","T.B","D","79","1422.6","7","26","15","11","33","45.83"
"488","Owen Tippett","PHI","R","77","1071.35","16","17","11","6","33","63.46"
"546","Andrei Svechnikov","CAR","R","64","889.65","17","16","10","6","33","73.33"
"548","Rasmus Dahlin","BUF","D","78","1529.2833333333","9","24","14","10","33","40.24"
"619","Alexander Barabanov","S.J","L","68","978.95","12","21","13","8","33","68.75"
"627","Wyatt Johnston","DAL","C","82","1066.2833333333","21","12","8","4","33","61.11"
"12","Blake Wheeler","WPG","R","72","940.31666666667","7","25","15","10","32","76.19"
"26","Brad Marchand","BOS","L","73","924.3","10","22","16","6","32","68.09"
"135","Kevin Hayes","PHI","C","81","1131.0666666667","10","22","19","3","32","71.11"
"148","Nino Niederreiter","NSH, WPG","R","78","1011.7666666667","19","13","6","7","32","69.57"
"168","Blake Coleman","CGY","C","82","1104.0833333333","12","20","12","8","32","72.73"
"183","Ryan Strome","ANA","C","82","1132.3833333333","10","22","10","12","32","68.09"
"312","Dylan Larkin","DET","C","80","1034.5333333333","9","23","16","7","32","69.57"
"339","Gustav Forsling","FLA","D","82","1487.6","12","20","14","6","32","40.51"
"369","Travis Konecny","PHI","R","60","850.38333333333","17","15","11","4","32","86.49"
"380","Daniel Sprong","SEA","R","66","618.81666666667","15","17","14","3","32","80.00"
"586","Kaapo Kakko","NYR","R","82","1111.15","15","17","11","6","32","61.54"
"7","Patrice Bergeron","BOS","C","78","882.36666666667","14","17","8","9","31","67.39"
"35","Jordan Staal","CAR","C","81","1044.25","15","16","6","10","31","68.89"
"62","Alex Pietrangelo","VGK","D","73","1297.6","7","24","10","14","31","49.21"
"70","Roman Josi","NSH","D","67","1289","8","23","15","8","31","49.21"
"114","Anders Lee","NYI","L","82","1100.2333333333","20","11","7","4","31","57.41"
"126","Evgeny Kuznetsov","WSH","C","81","1043.8666666667","6","25","17","8","31","67.39"
"137","Vladimir Tarasenko","NYR, STL","R","69","940.71666666667","12","19","10","9","31","67.39"
"145","Tyler Seguin","DAL","C","76","955.78333333333","10","21","10","11","31","75.61"
"189","J.T. Miller","VAN","C","81","1108.75","11","20","14","6","31","77.50"
"230","Jordan Martinook","CAR","L","82","1085.35","11","20","14","6","31","60.78"
"284","Darnell Nurse","EDM","D","82","1524.1833333333","7","24","12","12","31","42.47"
"288","Max Domi","CHI, DAL","C","80","1123.2833333333","7","24","17","7","31","67.39"
"402","Conor Garland","VAN","R","81","1045.4","12","19","9","10","31","77.50"
"536","Quinn Hughes","VAN","D","78","1469.2","4","27","13","14","31","38.27"
"543","K'Andre Miller","NYR","D","79","1465.3","7","24","9","15","31","46.27"
"5","Brent Burns","CAR","D","82","1390.9833333333","12","18","13","5","30","46.88"
"121","Mats Zuccarello","MIN","R","78","1170.6","9","21","18","3","30","69.77"
"273","J.T. Compher","COL","L","82","1188.5833333333","12","18","11","7","30","60.00"
"373","Mathew Barzal","NYI","C","58","819.2","9","21","16","5","30","76.92"
"388","Jake DeBrusk","BOS","L","64","757.25","19","11","8","3","30","63.83"
"423","Alex DeBrincat","OTT","R","82","1138","12","18","14","4","30","71.43"
"424","Patrik Laine","CBJ","L","55","803.8","13","17","10","7","30","83.33"
"444","Pierre-Luc Dubois","WPG","L","73","1011.0166666667","12","18","8","10","30","61.22"
"497","Miro Heiskanen","DAL","D","79","1523.6333333333","5","25","12","13","30","41.10"
"600","Matias Maccelli","ARI","L","64","812.81666666667","8","22","13","9","30","83.33"
"609","Jack Quinn","BUF","R","75","852.36666666667","13","17","9","8","30","65.22"
"122","Calle Jarnkrok","TOR","C","73","812.4","16","13","6","7","29","72.50"
"305","Sam Reinhart","FLA","C","82","1074.65","9","20","12","8","29","74.36"
"342","Kevin Labanc","S.J","R","72","901.43333333333","13","16","12","4","29","61.70"
"377","Jack Roslovic","CBJ","C","77","931.3","6","23","15","8","29","72.50"
"379","Anthony Beauvillier","NYI, VAN","L","82","1102.3","12","17","10","7","29","59.18"
"432","Trent Frederic","BOS","C","79","884.71666666667","16","13","6","7","29","61.70"
"487","Gabriel Vilardi","L.A","C, R","63","766.76666666667","17","12","7","5","29","87.88"
"519","Drake Batherson","OTT","R","82","1142.7666666667","7","22","15","7","29","67.44"
"545","Jesperi Kotkaniemi","CAR","C","82","1020.5833333333","12","17","5","12","29","67.44"
"611","Alexis Lafrenière","NYR","L","81","1083.6666666667","12","17","8","9","29","58.00"
"51","David Perron","DET","L","82","1035.1","15","13","11","2","28","56.00"
"98","Chris Kreider","NYR","L","79","996.15","19","9","6","3","28","58.33"
"115","Nick Jensen","WSH","D","77","1351.8666666667","5","23","14","9","28","54.90"
"149","Bryan Rust","PIT","R","81","1082.1833333333","14","14","7","7","28","54.90"
"182","Adam Larsson","SEA","D","82","1607.15","6","22","12","10","28","32.18"
"194","Phillip Danault","L.A","C","82","1104.1833333333","13","15","9","6","28","71.79"
"205","Hampus Lindholm","BOS","D","80","1381.6333333333","6","22","12","10","28","36.84"
"269","Shea Theodore","VGK","D","55","983.51666666667","5","23","9","14","28","53.85"
"503","Cale Makar","COL","D","60","1087.8833333333","9","19","9","10","28","50.91"
"576","Blake Lizotte","L.A","C","81","910.96666666667","10","18","14","4","28","65.12"
"587","Matt Boldy","MIN","L","81","1075.9333333333","20","8","3","5","28","70.00"
"84","Kyle Palmieri","NYI","C","55","748.03333333333","13","14","11","3","27","61.36"
"113","Erik Haula","N.J","L","80","1038.0666666667","10","17","10","7","27","54.00"
"167","Nick Cousins","FLA","C","79","844.83333333333","9","18","8","10","27","69.23"
"199","Barclay Goodrow","NYR","C","82","955.4","10","17","9","8","27","69.23"
"207","Brady Skjei","CAR","D","81","1433.6666666667","11","16","6","10","27","45.00"
"231","Damon Severson","N.J","D","81","1365.2166666667","4","23","11","12","27","45.00"
"237","Andreas Athanasiou","CHI","C","81","1090.7666666667","14","13","8","5","27","71.05"
"271","Ryan Hartman","MIN","R","59","794.65","11","16","10","6","27","77.14"
"275","Artturi Lehkonen","COL","L","64","927.71666666667","10","17","8","9","27","56.25"
"307","Sam Bennett","FLA","C","63","825.33333333333","9","18","11","7","27","61.36"
"313","Sonny Milano","WSH","L","64","763.65","10","17","8","9","27","67.50"
"330","Warren Foegele","EDM","L","67","776.01666666667","12","15","10","5","27","77.14"
"335","Viktor Arvidsson","L.A","L, R","77","1072.4166666667","12","15","12","3","27","65.85"
"349","Frank Vatrano","ANA","R","81","1088.9833333333","13","14","9","5","27","71.05"
"368","Tommy Novak","NSH","C","51","581.21666666667","11","16","11","5","27","81.82"
"475","Morgan Geekie","SEA","C","69","655.71666666667","8","19","11","8","27","65.85"
"618","JJ Peterka","BUF","R","77","924.71666666667","10","17","12","5","27","61.36"
"1","Eric Staal","FLA","C","72","816.86666666667","12","14","8","6","26","78.79"
"88","Victor Hedman","T.B","D","76","1373.8333333333","6","20","10","10","26","41.94"
"133","Nick Bjugstad","ARI, EDM","C","78","1006.9166666667","15","11","6","5","26","60.47"
"136","Cam Fowler","ANA","D","82","1509.2","6","20","10","10","26","47.27"
"172","Boone Jenner","CBJ","C","68","1050.6","15","11","7","4","26","61.90"
"173","Brandon Saad","STL","L","71","933.48333333333","12","14","11","3","26","63.41"
"218","Filip Forsberg","NSH","L","50","651.11666666667","14","12","8","4","26","72.22"
"251","MacKenzie Weegar","CGY","D","81","1430.7333333333","4","22","8","14","26","41.94"
"265","Andrew Copp","DET","C","82","1062.2166666667","5","21","14","7","26","65.00"
"296","Conor Sheary","WSH","L","82","1029.2666666667","11","15","11","4","26","54.17"
"413","Brandon Tanev","SEA","L","82","917.81666666667","10","16","10","6","26","65.00"
"419","Charlie McAvoy","BOS","D","67","1093.2333333333","3","23","13","10","26","43.33"
"551","Barrett Hayton","ARI","C","82","1075.4333333333","12","14","8","6","26","50.98"
"555","Noah Dobson","NYI","D","78","1211.5666666667","7","19","12","7","26","42.62"
"595","Alex Newhook","COL","C","82","999.35","11","15","8","7","26","60.47"
"37","Phil Kessel","VGK","C, R","82","917.28333333333","12","13","5","8","25","64.10"
"75","Adam Henrique","ANA","C","62","772.83333333333","15","10","4","6","25","71.43"
"143","Taylor Hall","BOS","L","61","788.63333333333","9","16","10","6","25","65.79"
"153","Jesper Fast","CAR","R","80","1025.5166666667","10","15","5","10","25","59.52"
"240","Josh Anderson","MTL","R","69","918.85","15","10","7","3","25","53.19"
"276","William Carrier","VGK","L","56","660.38333333333","16","9","8","1","25","78.13"
"290","Alex Wennberg","SEA","C","82","1093.3333333333","7","18","11","7","25","58.14"
"309","Nikolaj Ehlers","WPG","L","45","549.55","9","16","12","4","25","92.59"
"328","Ryan Donato","SEA","C","71","751.83333333333","14","11","8","3","25","59.52"
"333","Michael Amadio","VGK","C, R","67","774.06666666667","15","10","8","2","25","64.10"
"345","Pierre Engvall","NYI, TOR","L","76","909.95","15","10","7","3","25","55.56"
"443","Samuel Girard","COL","D","76","1387.9","4","21","7","14","25","45.45"
"520","Noah Cates","PHI","L","82","1094.1666666667","8","17","9","8","25","59.52"
"539","Evan Bouchard","EDM","D","82","1234.7666666667","5","20","7","13","25","37.88"
"596","Ilya Mikheyev","VAN","R","46","619.63333333333","12","13","8","5","25","62.50"
"608","Seth Jarvis","CAR","C","82","1090.0833333333","13","12","6","6","25","55.56"
"155","Mark Stone","VGK","R","43","620.35","11","13","8","5","24","68.57"
"232","Colton Sissons","NSH","C","82","972.28333333333","9","15","4","11","24","68.57"
"239","Erik Gustafsson","TOR, WSH","D","70","1143.9","7","17","9","8","24","44.44"
"243","Alexander Kerfoot","TOR","C","82","971.93333333333","6","18","10","8","24","58.54"
"249","Dominik Kubalik","DET","L","81","957.71666666667","12","12","9","3","24","55.81"
"263","Miles Wood","N.J","L","76","819.96666666667","11","13","9","4","24","75.00"
"287","Valeri Nichushkin","COL","R","53","734.91666666667","5","19","10","9","24","63.16"
"318","Kasperi Kapanen","PIT, STL","R","66","737.65","8","16","12","4","24","77.42"
"343","Sammy Blais","NYR, STL","L","71","767.4","9","15","6","9","24","72.73"
"350","Noah Hanifin","CGY","D","81","1406.8333333333","5","19","10","9","24","35.29"
"351","Rasmus Andersson","CGY","D","79","1393.05","8","16","11","5","24","35.29"
"393","Evan Rodrigues","COL","C","69","1021.45","8","16","9","7","24","47.06"
"448","Michael McLeod","N.J","C","80","860.78333333333","3","21","11","10","24","70.59"
"507","Alex Iafallo","L.A","L","59","725.23333333333","6","18","10","8","24","75.00"
"509","Neal Pionk","WPG","D","82","1419.4833333333","6","18","7","11","24","42.11"
"550","Ty Dellandrea","DAL","C","82","976.08333333333","8","16","9","7","24","57.14"
"575","Nico Sturm","S.J","C","74","852.51666666667","12","12","7","5","24","64.86"
"583","Cole Caufield","MTL","R","46","632.65","17","7","2","5","24","64.86"
"623","Kent Johnson","CBJ","C","79","964.3","9","15","11","4","24","61.54"
"625","Owen Power","BUF","D","79","1560.3833333333","3","21","8","13","24","27.27"
"628","Mason McTavish","ANA","C","80","999.18333333333","8","16","12","4","24","72.73"
"80","Jared Spurgeon","MIN","D","79","1274.6166666667","9","14","7","7","23","40.35"
"83","Marcus Johansson","MIN, WSH","L","80","972.45","11","12","8","4","23","51.11"
"105","Mattias Ekholm","EDM, NSH","D","78","1304.2333333333","8","15","10","5","23","36.51"
"116","Nic Dowd","WSH","C","65","692.23333333333","13","10","7","3","23","74.19"
"139","Jaden Schwartz","SEA","C","71","997.88333333333","9","14","8","6","23","65.71"
"166","Adam Lowry","WPG","C","82","932.61666666667","9","14","7","7","23","69.70"
"264","Nicholas Paul","T.B","L","80","1041.1333333333","9","14","7","7","23","53.49"
"344","Victor Olofsson","BUF","L","75","847.28333333333","17","6","5","1","23","67.65"
"411","Mason Marchment","DAL","L","68","923.5","8","15","9","6","23","74.19"
"456","Ross Colton","T.B","C","81","889.33333333333","12","11","8","3","23","71.88"
"508","David Kampf","TOR","C","82","997.93333333333","7","16","7","9","23","62.16"
"553","Jack McBain","ARI","C","82","927.35","10","13","8","5","23","74.19"
"557","Rasmus Sandin","TOR, WSH","D","71","1157.8666666667","7","16","6","10","23","38.33"
"569","Yegor Sharangovich","N.J","C","75","897.88333333333","9","14","8","6","23","63.89"
"574","Logan O'Connor","COL","R","82","985.21666666667","7","16","11","5","23","60.53"
"590","Shane Pinto","OTT","C","82","1055.6666666667","14","9","4","5","23","63.89"
"617","Cole Perfetti","WPG","C","51","662.75","5","18","8","10","23","79.31"
"21","T.J. Oshie","WSH","R","58","723.9","10","12","5","7","22","75.86"
"54","Evgenii Dadonov","DAL, MTL","R","73","908.41666666667","7","15","8","7","22","57.89"
"161","Dylan DeMelo","WPG","D","75","1230.2666666667","3","19","9","10","22","41.51"
"170","Jean-Gabriel Pageau","NYI","C","70","861.36666666667","3","19","11","8","22","62.86"
"171","Scott Mayfield","NYI","D","82","1442.2333333333","6","16","7","9","22","43.14"
"176","Matt Nieto","COL, S.J","L","81","897.68333333333","11","11","4","7","22","56.41"
"188","Jamie Oleksiak","SEA","D","75","1193.75","7","15","6","9","22","37.93"
"208","Scott Laughton","PHI","C","78","1056.1","8","14","6","8","22","52.38"
"210","Olli Maatta","DET","D","78","1282.7166666667","5","17","8","9","22","53.66"
"220","Matt Grzelcyk","BOS","D","75","1186.4833333333","3","19","8","11","22","31.43"
"268","Andre Burakovsky","SEA","L","49","656.25","8","14","10","4","22","73.33"
"294","Anthony Mantha","WSH","R","67","854.41666666667","10","12","8","4","22","62.86"
"301","Frederick Gaudreau","MIN","C","82","980.78333333333","9","13","8","5","22","61.11"
"435","Tyson Jost","BUF, MIN","C","71","826.2","5","17","8","9","22","68.75"
"484","Eeli Tolvanen","NSH, SEA","R","61","722.05","14","8","5","3","22","53.66"
"4","Zach Parise","NYI","L","82","1007.1","12","9","6","3","21","60.00"
"9","Mark Giordano","TOR","D","78","1211.1666666667","2","19","8","11","21","37.50"
"27","Nick Foligno","BOS","L","60","637.45","8","13","10","3","21","63.64"
"47","James van Riemsdyk","PHI","L","61","772.25","8","13","7","6","21","61.76"
"65","Josh Bailey","NYI","R","64","774.18333333333","8","13","8","5","21","60.00"
"85","Ryan O'Reilly","STL, TOR","C","53","728.55","11","10","5","5","21","63.64"
"90","Evander Kane","EDM","L","41","641.93333333333","14","7","3","4","21","80.77"
"102","Tyson Barrie","EDM, NSH","D","85","1309.9833333333","8","13","8","5","21","41.18"
"103","Dmitry Orlov","BOS, WSH","D","66","1178.3","4","17","5","12","21","43.75"
"147","Mikael Granlund","NSH, PIT","C","79","1011.0166666667","6","15","8","7","21","58.33"
"160","Travis Boyd","ARI","C","82","1036.0833333333","12","9","5","4","21","53.85"
"195","Vladislav Namestnikov","T.B, WPG","C","77","824.15","7","14","5","9","21","61.76"
"211","Mike Matheson","MTL","D","48","858.26666666667","6","15","10","5","21","58.33"
"217","Jacob Trouba","NYR","D","82","1418.7333333333","5","16","8","8","21","31.82"
"221","Colton Parayko","STL","D","79","1554.75","4","17","5","12","21","42.00"
"234","Jake McCabe","CHI, TOR","D","76","1275.35","3","18","9","9","21","34.43"
"236","Jaccob Slavin","CAR","D","76","1368.75","4","17","8","9","21","35.59"
"241","Matthew Benning","S.J","D","77","1205.5833333333","1","20","11","9","21","45.65"
"267","Ryan Graves","N.J","D","78","1326.8833333333","8","13","4","9","21","30.00"
"291","Ryan Pulock","NYI","D","82","1438.35","4","17","8","9","21","31.34"
"300","Garnet Hathaway","BOS, WSH","R","84","851.23333333333","13","8","3","5","21","63.64"
"324","Marcus Pettersson","PIT","D","68","1225.2333333333","1","20","13","7","21","37.50"
"366","Christian Fischer","ARI","R","80","948.38333333333","11","10","7","3","21","70.00"
"392","Anthony Cirelli","T.B","C","58","740.9","7","14","10","4","21","60.00"
"427","Jakob Chychrun","ARI, OTT","D","48","857.11666666667","4","17","5","12","21","46.67"
"430","Sam Steel","MIN","C","65","828.06666666667","8","13","5","8","21","56.76"
"471","Kailer Yamamoto","EDM","R","58","821.9","9","12","5","7","21","52.50"
"476","Michael Rasmussen","DET","C","56","676.4","7","14","9","5","21","67.74"
"482","Jesper Boqvist","N.J","C","70","758.43333333333","10","11","4","7","21","63.64"
"578","Peyton Krebs","BUF","C","74","873.88333333333","7","14","7","7","21","70.00"
"584","Moritz Seider","DET","D","82","1326.4166666667","3","18","9","9","21","38.18"
"2","Ryan Suter","DAL","D","82","1363.85","3","17","7","10","20","36.36"
"64","Luke Schenn","TOR, VAN","D","70","1013.9","4","16","10","6","20","40.82"
"77","Gustav Nyquist","CBJ, MIN","C, L","51","677.16666666667","8","12","7","5","20","74.07"
"82","Mike Hoffman","MTL","L","67","834.58333333333","11","9","5","4","20","64.52"
"97","Nick Leddy","STL","D","78","1448.0333333333","2","18","10","8","20","30.77"
"193","Stefan Noesen","CAR","R","78","735","5","15","8","7","20","64.52"
"216","Teuvo Teravainen","CAR","L","68","824.26666666667","4","16","12","4","20","54.05"
"254","Connor Clifton","BOS","D","78","1235.35","4","16","8","8","20","34.48"
"270","Jason Dickinson","CHI","C","78","1003.0666666667","8","12","7","5","20","62.50"
"278","Brett Pesce","CAR","D","82","1449.25","2","18","11","7","20","30.77"
"282","Seth Jones","CHI","D","72","1309.1333333333","8","12","6","6","20","40.00"
"297","Trevor van Riemsdyk","WSH","D","75","1172.2833333333","7","13","5","8","20","32.79"
"336","Sam Lafferty","CHI, TOR","C","70","829.75","8","12","7","5","20","76.92"
"337","Danton Heinen","PIT","L","65","642.25","7","13","8","5","20","80.00"
"340","Dakota Joshua","VAN","C","79","811.73333333333","9","11","5","6","20","83.33"
"400","Denis Malgin","COL, TOR","C","65","661.36666666667","13","7","5","2","20","80.00"
"412","Ryan Lomberg","FLA","L","82","882.03333333333","12","8","5","3","20","52.63"
"441","Taylor Raddysh","CHI","R","78","1014.2","12","8","3","5","20","64.52"
"478","Cody Glass","NSH","C","72","842.98333333333","6","14","7","7","20","58.82"
"515","Fabian Zetterlund","N.J, S.J","L","67","816.83333333333","5","15","11","4","20","62.50"
"522","Nick Perbix","T.B","D","69","1010.9166666667","5","15","10","5","20","40.82"
"528","Sean Durzi","L.A","D","72","1105.0666666667","8","12","5","7","20","43.48"
"530","Pius Suter","DET","C","79","937.36666666667","12","8","5","3","20","64.52"
"532","Eric Robinson","CBJ","L","72","825.6","10","10","4","6","20","90.91"
"538","Ryan McLeod","EDM","C","57","645.16666666667","9","11","8","3","20","74.07"
"566","Alexander Romanov","NYI","D","76","1288.8","2","18","9","9","20","37.74"
"605","Lucas Raymond","DET","L","74","971.48333333333","10","10","5","5","20","60.61"
"29","Kyle Okposo","BUF","R","75","926.26666666667","6","13","7","6","19","67.86"
"33","Jeff Petry","PIT","D","61","1031.7333333333","3","16","5","11","19","37.25"
"60","Drew Doughty","L.A","D","81","1566.5","4","15","3","12","19","32.20"
"104","Brian Dumoulin","PIT","D","82","1401.9833333333","1","18","12","6","19","36.54"
"154","John Klingberg","ANA, MIN","D","67","1127.5333333333","6","13","10","3","19","43.18"
"204","Morgan Rielly","TOR","D","65","1083.6166666667","3","16","11","5","19","41.30"
"225","Shayne Gostisbehere","ARI, CAR","D","75","1231.9166666667","4","15","7","8","19","36.54"
"229","Jimmy Vesey","NYR","L","81","956.25","7","12","6","6","19","46.34"
"260","Mattias Janmark","EDM","C","66","814.36666666667","5","14","9","5","19","63.33"
"277","Tyler Bertuzzi","BOS, DET","L","50","653","4","15","10","5","19","57.58"
"292","Nikita Zadorov","CGY","D","82","1295.2833333333","13","6","4","2","19","30.16"
"316","Tony DeAngelo","PHI","D","70","1172.3","5","14","9","5","19","39.58"
"329","Christian Dvorak","MTL","C","64","780.8","6","13","3","10","19","76.00"
"353","Jonas Siegenthaler","N.J","D","80","1382.8833333333","3","16","7","9","19","24.36"
"378","Nicolas Roy","VGK","C","65","825.93333333333","9","10","7","3","19","59.38"
"398","Will Borgen","SEA","D","82","1188.7333333333","3","16","9","7","19","32.20"
"433","Max Jones","ANA","L","69","836.68333333333","9","10","4","6","19","82.61"
"485","Klim Kostin","EDM","C","57","563.85","11","8","6","2","19","67.86"
"521","Sebastian Aho","NYI","D","71","1064.5","4","15","6","9","19","38.78"
"535","Philipp Kurashev","CHI","C","70","966.5","8","11","8","3","19","48.72"
"614","Anton Lundell","FLA","C","73","872.21666666667","9","10","5","5","19","48.72"
"616","Quinton Byfield","L.A","C","53","657.1","1","18","10","8","19","51.35"
"16","Paul Stastny","CAR","C","73","738.28333333333","7","11","5","6","18","62.07"
"45","Kevin Shattenkirk","ANA","D","75","1179.95","3","15","7","8","18","37.50"
"58","Lars Eller","COL, WSH","C","84","1051.15","8","10","7","3","18","51.43"
"79","Matt Martin","NYI","L","81","881.48333333333","7","11","7","4","18","64.29"
"117","Brenden Dillon","WPG","D","82","1347.0166666667","2","16","9","7","18","39.13"
"157","Ondrej Palat","N.J","L","49","658.48333333333","7","11","8","3","18","58.06"
"197","Colin Miller","DAL","D","79","1237.8166666667","5","13","7","6","18","29.51"
"219","Radek Faksa","DAL","C","81","918.1","10","8","5","3","18","69.23"
"222","Oskar Sundqvist","DET, MIN","C","67","723.55","6","12","5","7","18","64.29"
"223","Esa Lindell","DAL","D","82","1280.6166666667","5","13","6","7","18","33.33"
"257","Hudson Fasching","NYI","R","49","598.2","10","8","6","2","18","54.55"
"281","Jonathan Drouin","MTL","L","58","700.48333333333","2","16","9","7","18","78.26"
"314","Travis Sanheim","PHI","D","81","1391.5666666667","6","12","9","3","18","39.13"
"367","Keegan Kolesar","VGK","R","74","835.51666666667","8","10","10","0","18","58.06"
"389","Ivan Provorov","PHI","D","82","1508.3833333333","5","13","5","8","18","32.14"
"391","Yakov Trenin","NSH","C","77","942.81666666667","9","9","6","3","18","78.26"
"409","Matt Roy","L.A","D","82","1292.2666666667","5","13","5","8","18","30.00"
"422","Carl Grundstrom","L.A","R","57","568.75","11","7","5","2","18","72.00"
"501","Pierre-Olivier Joseph","PIT","D","75","1040.0166666667","4","14","7","7","18","33.96"
"510","Calle Rosen","STL","D","49","697.6","8","10","4","6","18","40.91"
"565","Jonatan Berggren","DET","R","67","773.1","9","9","5","4","18","64.29"
"567","Paul Cotter","VGK","C","55","679.01666666667","13","5","2","3","18","69.23"
"579","Kirby Dach","MTL","C","58","802.18333333333","8","10","6","4","18","48.65"
"622","J.J. Moser","ARI","D","82","1241.9833333333","3","15","7","8","18","37.50"
"22","Andrew Cogliano","COL","C","79","829.73333333333","10","7","3","4","17","56.67"
"30","Trevor Lewis","CGY","C","82","825.03333333333","6","11","7","4","17","62.96"
"31","Milan Lucic","CGY","L","77","841.51666666667","7","10","8","2","17","54.84"
"71","Justin Schultz","SEA","D","73","1090.05","5","12","4","8","17","34.69"
"81","Tyler Johnson","CHI","C","56","739.5","6","11","6","5","17","70.83"
"106","Marcus Foligno","MIN","L","65","802.75","7","10","6","4","17","65.38"
"110","David Savard","MTL","D","62","1119.0333333333","3","14","5","9","17","45.95"
"112","Ben Chiarot","DET","D","76","1286","3","14","7","7","17","36.96"
"118","Radko Gudas","FLA","D","72","1023.65","2","15","7","8","17","36.17"
"123","Justin Holl","TOR","D","80","1329.5","2","15","2","13","17","27.87"
"252","Tyler Motte","NYR, OTT","C, L","62","626.18333333333","6","11","7","4","17","77.27"
"395","Noel Acciari","STL, TOR","C","77","941.06666666667","10","7","3","4","17","68.00"
"396","Derek Ryan","EDM","C","80","774.03333333333","11","6","3","3","17","54.84"
"465","Trevor Moore","L.A","C, L","59","771.38333333333","6","11","8","3","17","70.83"
"470","Juuso Valimaki","ARI","D","78","1170.7666666667","2","15","6","9","17","32.08"
"479","Mikey Anderson","L.A","D","77","1433.8166666667","4","13","2","11","17","29.31"
"495","Max Comtois","ANA","L","64","794.65","9","8","5","3","17","56.67"
"523","Alexey Toropchenko","STL","R","69","738.96666666667","8","9","5","4","17","60.71"
"23","Marc-Edouard Vlasic","S.J","D","78","1121.7333333333","1","15","3","12","16","35.56"
"24","Kris Letang","PIT","D","64","1226.4833333333","4","12","3","9","16","30.77"
"42","Nick Bonino","PIT, S.J","C","62","716.66666666667","9","7","6","1","16","51.61"
"56","Ryan McDonagh","NSH","D","71","1234.2","2","14","8","6","16","29.09"
"72","Travis Hamonic","OTT","D","75","1110.8666666667","5","11","5","6","16","33.33"
"109","Casey Cizikas","NYI","C","81","972.16666666667","5","11","7","4","16","57.14"
"130","Tyler Pitlick","STL","C","61","594.98333333333","7","9","7","2","16","69.57"
"169","Josh Leivo","STL","L","51","566.98333333333","4","12","9","3","16","59.26"
"228","Adam Pelech","NYI","D","61","1105.2833333333","5","11","6","5","16","34.78"
"238","Brett Kulak","EDM","D","82","1251.7333333333","3","13","2","11","16","28.57"
"310","Nick Ritchie","ARI, CGY","L","74","817.53333333333","9","7","5","2","16","55.17"
"408","Steven Lorentz","S.J","C","80","802.05","8","8","2","6","16","72.73"
"437","Josh Mahura","FLA","D","82","1082.2333333333","4","12","8","4","16","32.00"
"442","Noah Gregor","S.J","C","57","692.5","10","6","5","1","16","64.00"
"450","Filip Hronek","DET, VAN","D","64","1061.7833333333","4","12","4","8","16","34.04"
"463","Tanner Jeannot","NSH, T.B","L","76","881.61666666667","5","11","5","6","16","55.17"
"472","Nicolas Hague","VGK","D","81","1377.6833333333","2","14","9","5","16","27.59"
"560","Jordan Harris","MTL","D","65","1096.7666666667","4","12","5","7","16","34.04"
"561","Kirill Marchenko","CBJ","R","59","763.1","13","3","3","0","16","64.00"
"603","Braden Schneider","NYR","D","81","1188.2333333333","5","11","5","6","16","32.65"
"606","Kaiden Guhle","MTL","D","44","744.13333333333","4","12","9","3","16","53.33"
"3","Jeff Carter","PIT","C","79","833.63333333333","7","8","3","5","15","62.50"
"25","Ryan Reaves","MIN, NYR","R","73","671.25","5","10","5","5","15","71.43"
"86","Jakob Silfverberg","ANA","R","81","855.6","6","9","6","3","15","57.69"
"92","Oliver Ekman-Larsson","VAN","D","54","908.6","2","13","9","4","15","40.54"
"96","Dmitry Kulikov","ANA, PIT","D","67","1068","3","12","8","4","15","37.50"
"107","Craig Smith","BOS, WSH","C","64","673.68333333333","9","6","1","5","15","51.72"
"144","Ryan Johansen","NSH","C","55","633.13333333333","6","9","5","4","15","68.18"
"201","Torey Krug","STL","D","63","949.75","3","12","6","6","15","36.59"
"255","Carson Soucy","SEA","D","78","1105.9","3","12","4","8","15","28.85"
"304","Aaron Ekblad","FLA","D","71","1149.7166666667","4","11","8","3","15","28.85"
"426","Jesse Puljujarvi","CAR, EDM","R","75","854.1","5","10","6","4","15","53.57"
"516","Johnathan Kovacevic","MTL","D","77","1165.7","3","12","6","6","15","28.85"
"518","Emil Bemstrom","CBJ","R","55","586.95","3","12","7","5","15","65.22"
"524","Morgan Barron","WPG","C","70","790","6","9","5","4","15","62.50"
"542","Joe Veleno","DET","C","81","935.21666666667","8","7","4","3","15","50.00"
"589","Arthur Kaliyev","L.A","R","56","527.3","5","10","4","6","15","60.00"
"598","Aliaksei Protas","WSH","C","58","641.66666666667","4","11","5","6","15","65.22"
"599","Juuso Parssinen","NSH","C","45","540.38333333333","3","12","6","6","15","65.22"
"20","Marc Staal","FLA","D","82","1239.15","3","11","4","7","14","22.58"
"39","Jonathan Toews","CHI","C","53","685.8","4","10","6","4","14","70.00"
"43","Ian Cole","T.B","D","78","1242.7833333333","3","11","7","4","14","26.92"
"78","Derek Grant","ANA","C","46","510.96666666667","3","11","7","4","14","73.68"
"150","Jani Hakanpää","DAL","D","82","1274.7166666667","5","9","4","5","14","27.45"
"206","Matt Dumba","MIN","D","79","1453.85","4","10","6","4","14","31.11"
"212","Zemgus Girgensons","BUF","L","80","894.6","9","5","1","4","14","66.67"
"235","Brock McGinn","ANA, PIT","L","75","791.35","9","5","2","3","14","60.87"
"272","Adam Erne","DET","L","61","699.86666666667","6","8","4","4","14","70.00"
"303","Tomas Nosek","BOS","L","66","639.76666666667","4","10","5","5","14","70.00"
"332","Jake Walman","DET","D","63","1007.55","8","6","2","4","14","32.56"
"341","Oskar Lindblom","S.J","L","73","679.45","6","8","3","5","14","60.87"
"347","Jake Middleton","MIN","D","79","1284.2","3","11","5","6","14","30.43"
"354","Colin White","FLA","C","68","607.33333333333","7","7","5","2","14","58.33"
"365","Evgeny Svechnikov","S.J","L","59","604.53333333333","8","6","5","1","14","53.85"
"382","Thomas Chabot","OTT","D","68","1335.2166666667","4","10","4","6","14","21.54"
"387","Denis Gurianov","DAL, MTL","R","66","769.56666666667","6","8","7","1","14","60.87"
"416","Wade Allison","PHI","R","60","748.85","9","5","1","4","14","60.87"
"418","Ryan Lindgren","NYR","D","63","1020.6666666667","0","14","9","5","14","28.57"
"420","Julien Gauthier","NYR, OTT","R","57","483.9","9","5","3","2","14","73.68"
"438","Boris Katchouk","CHI","L","58","606.7","5","9","6","3","14","77.78"
"447","Nathan Bastian","N.J","R","43","429.56666666667","6","8","4","4","14","87.50"
"452","Troy Stecher","ARI, CGY","D","81","1120.1","3","11","7","4","14","42.42"
"459","Michael Pezzetta","MTL","L","63","553.15","7","7","7","0","14","53.85"
"462","Michael Eyssimont","S.J, T.B, WPG","C","54","613.15","5","9","4","5","14","50.00"
"467","Zach Aston-Reese","TOR","C","77","764.4","10","4","2","2","14","66.67"
"469","Mason Shaw","MIN","C","59","563.93333333333","6","8","3","5","14","87.50"
"483","Adam Ruzicka","CGY","C","44","429.55","4","10","6","4","14","77.78"
"533","Martin Fehervary","WSH","D","67","1180.8","4","10","5","5","14","31.11"
"549","Rasmus Kupari","L.A","C","66","584.66666666667","3","11","7","4","14","63.64"
"552","Liam Foudy","CBJ","C","62","670.8","7","7","6","1","14","73.68"
"568","Jesse Ylonen","MTL","R","37","445.01666666667","5","9","3","6","14","93.33"
"585","Cam York","PHI","D","54","900.55","2","12","7","5","14","36.84"
"610","Jake Sanderson","OTT","D","77","1174.35","2","12","7","5","14","30.43"
"621","Nils Aman","VAN","C","68","760.91666666667","4","10","5","5","14","70.00"
"36","Derick Brassard","OTT","C","62","612.08333333333","8","5","4","1","13","54.17"
"46","Pat Maroon","T.B","L","80","814.95","5","8","4","4","13","59.09"
"59","Nick Holden","OTT","D","65","884.68333333333","2","11","5","6","13","41.94"
"76","TJ Brodie","TOR","D","58","1015.7333333333","2","11","3","8","13","29.55"
"163","Nick Seeler","PHI","D","77","1030.2","4","9","6","3","13","31.71"
"164","Sean Kuraly","CBJ","C","71","870.46666666667","6","7","5","2","13","56.52"
"233","Teddy Blueger","PIT, VGK","C","63","662.46666666667","3","10","8","2","13","68.42"
"247","Nate Schmidt","WPG","D","71","1069.4166666667","4","9","4","5","13","36.11"
"346","Jake Evans","MTL","C","54","607.13333333333","0","13","11","2","13","68.42"
"371","Brandon Carlo","BOS","D","75","1130.25","2","11","6","5","13","22.03"
"390","John Marino","N.J","D","64","1084.1666666667","1","12","10","2","13","29.55"
"406","Vladislav Gavrikov","CBJ, L.A","D","72","1262.3333333333","3","10","6","4","13","29.55"
"457","Axel Jonsson-Fjallby","WPG","L","50","470.13333333333","6","7","3","4","13","81.25"
"464","Mathieu Olivier","CBJ","R","66","720.6","5","8","6","2","13","61.90"
"468","Gavin Bayreuther","CBJ","D","51","741.03333333333","2","11","4","7","13","52.00"
"496","Henri Jokiharju","BUF","D","60","1095.0833333333","3","10","3","7","13","24.07"
"499","Timothy Liljegren","TOR","D","67","1026.9","5","8","4","4","13","26.00"
"505","Erik Brannstrom","OTT","D","74","985.83333333333","2","11","5","6","13","33.33"
"556","Adam Boqvist","CBJ","D","46","677.91666666667","5","8","4","4","13","39.39"
"564","Connor Dewar","MIN","C","81","736.61666666667","3","10","5","5","13","76.47"
"571","Rafael Harvey-Pinard","MTL","L","34","453.2","8","5","3","2","13","48.15"
"580","Bowen Byram","COL","D","42","790.56666666667","5","8","6","2","13","39.39"
"6","Corey Perry","T.B","R","81","762.4","6","6","4","2","12","52.17"
"66","Tyler Myers","VAN","D","78","1399.1166666667","1","11","6","5","12","21.43"
"94","Calvin de Haan","CAR","D","53","682.03333333333","2","10","4","6","12","40.00"
"99","Brayden McNabb","VGK","D","82","1408.4","1","11","6","5","12","20.00"
"152","Brendan Gallagher","MTL","R","37","442.45","8","4","4","0","12","63.16"
"174","Brett Ritchie","ARI, CGY","R","50","488.51666666667","8","4","1","3","12","66.67"
"213","Cody Ceci","EDM","D","80","1318.6666666667","1","11","4","7","12","21.82"
"326","Nicolas Aube-Kubel","TOR, WSH","R","53","587.06666666667","4","8","3","5","12","57.14"
"361","Erik Cernak","T.B","D","70","1088.9166666667","1","11","5","6","12","26.09"
"375","Ethan Bear","VAN","D","61","979.06666666667","2","10","5","5","12","29.27"
"383","Mathieu Joseph","OTT","R","56","594.8","0","12","8","4","12","46.15"
"407","Mason Appleton","WPG","C","41","538.85","3","9","4","5","12","57.14"
"410","Jalen Chatfield","CAR","D","78","1019.8","5","7","4","3","12","24.49"
"431","Brett Howden","VGK","C","54","654.46666666667","5","7","4","3","12","54.55"
"531","Zach Whitecloud","VGK","D","59","904.73333333333","5","7","4","3","12","30.00"
"558","Nils Lundkvist","DAL","D","60","866.38333333333","4","8","4","4","12","33.33"
"602","Cole Smith","NSH","L","69","717.95","3","9","8","1","12","66.67"
"613","Justin Barron","MTL","D","39","559.85","2","10","5","5","12","41.38"
"15","Alexander Edler","L.A","D","64","843.85","2","9","5","4","11","28.21"
"69","John Carlson","WSH","D","40","664.55","3","8","5","3","11","34.38"
"111","Nicolas Deslauriers","PHI","L","80","735.5","5","6","1","5","11","61.11"
"129","Jon Merrill","MIN","D","73","1007.2833333333","2","9","5","4","11","30.56"
"142","Erik Gudbranson","CBJ","D","70","1283.3166666667","1","10","4","6","11","27.50"
"159","Josh Archibald","PIT","R","62","505.06666666667","5","6","2","4","11","52.38"
"190","Joel Armia","MTL","R","43","496.36666666667","5","6","3","3","11","91.67"
"214","Tom Wilson","WSH","R","33","430.08333333333","5","6","4","2","11","55.00"
"285","Rasmus Ristolainen","PHI","D","74","1150.5666666667","1","10","4","6","11","25.58"
"298","Jordan Oesterle","DET","D","52","788.83333333333","2","9","3","6","11","44.00"
"299","Patrick Brown","OTT, PHI","C","61","605.16666666667","3","8","4","4","11","57.89"
"302","Pierre-Edouard Bellemare","T.B","L","73","650.71666666667","4","7","6","1","11","61.11"
"363","A.J. Greer","BOS","L","61","542.5","4","7","4","3","11","52.38"
"376","Caleb Jones","CHI","D","73","1204.3666666667","2","9","4","5","11","25.00"
"454","Rem Pitlick","MTL","C","46","515.9","3","8","6","2","11","78.57"
"477","Jaret Anderson-Dolan","L.A","C","46","456.21666666667","7","4","2","2","11","61.11"
"526","Sean Walker","L.A","D","70","921.66666666667","3","8","5","3","11","27.50"
"527","Mark Kastelic","OTT","C","65","525.66666666667","7","4","2","2","11","64.71"
"563","Ilya Lyubushkin","BUF","D","68","865.86666666667","1","10","4","6","11","35.48"
"601","Drew O'Connor","PIT","L","46","421.35","5","6","3","3","11","73.33"
"32","Cal Clutterbuck","NYI","R","49","500.16666666667","5","5","2","3","10","55.56"
"48","Sam Gagner","WPG","C","48","495.35","6","4","3","1","10","58.82"
"57","Alec Martinez","VGK","D","77","1285.8","1","9","3","6","10","15.87"
"73","Derek Stepan","CAR","C","73","607.46666666667","5","5","4","1","10","45.45"
"120","Chris Tanev","CGY","D","65","1061.9","1","9","4","5","10","22.22"
"134","Derek Forbort","BOS","D","54","764.78333333333","3","7","5","2","10","31.25"
"158","Josh Manson","COL","D","27","407.81666666667","2","8","6","2","10","43.48"
"178","Scott Harrington","ANA, S.J","D","45","700.81666666667","3","7","3","4","10","30.30"
"187","Jonas Brodin","MIN","D","60","1067.1333333333","2","8","1","7","10","23.81"
"244","Jaycob Megna","S.J, SEA","D","54","906.96666666667","1","9","4","5","10","22.22"
"245","Liam O'Brien","ARI","C","56","579.4","3","7","4","3","10","62.50"
"253","Saku Maenalanen","WPG","R","64","561.63333333333","4","6","2","4","10","71.43"
"295","Nathan Walker","STL","L","56","535.36666666667","2","8","4","4","10","43.48"
"359","Jordan Greenway","BUF, MIN","L","62","769.55","5","5","2","3","10","34.48"
"381","Jeremy Lauzon","NSH","D","67","942.88333333333","3","7","1","6","10","34.48"
"434","Andrew Peeke","CBJ","D","80","1408.1333333333","5","5","2","3","10","22.73"
"466","Zack MacEwen","L.A, PHI","C","56","608.13333333333","4","6","1","5","10","62.50"
"502","Ryan Poehling","PIT","C","53","483.71666666667","4","6","5","1","10","66.67"
"525","Sheldon Dries","VAN","C","63","597.16666666667","6","4","2","2","10","45.45"
"540","Isac Lundestrom","ANA","C","61","705.43333333333","3","7","3","4","10","50.00"
"629","Arber Xhekaj","MTL","D","51","713.73333333333","3","7","5","2","10","41.67"
"38","Nicklas Backstrom","WSH","C","39","487.95","1","8","5","3","9","64.29"
"156","Colin Blackwell","CHI","C","53","536.18333333333","2","7","6","1","9","64.29"
"192","Connor Murphy","CHI","D","80","1345.7333333333","4","5","3","2","9","20.93"
"200","Brad Hunt","COL","D","47","515.75","3","6","3","3","9","45.00"
"209","Mark Jankowski","NSH","C","50","514.05","4","5","3","2","9","75.00"
"226","Devin Shore","EDM","C","47","403.15","1","8","6","2","9","69.23"
"227","Jujhar Khaira","CHI","L","51","571.9","4","5","2","3","9","56.25"
"322","Brendan Lemieux","L.A, PHI","L","45","441.05","2","7","5","2","9","60.00"
"436","Dante Fabbro","NSH","D","79","1181.4","1","8","3","5","9","25.00"
"455","Brandon Duhaime","MIN","R","51","493.15","8","1","1","0","9","50.00"
"541","Mattias Samuelsson","BUF","D","55","1026.0666666667","2","7","3","4","9","16.36"
"572","Simon Benoit","ANA","D","78","1233","3","6","1","5","9","22.50"
"577","Brett Leason","ANA","R","54","578.51666666667","6","3","2","1","9","69.23"
"593","Simon Holmstrom","NYI","R","50","534.15","6","3","1","2","9","64.29"
"604","Dylan Holloway","EDM","L","51","449.21666666667","3","6","2","4","9","52.94"
"74","Michael Stone","CGY","D","48","585.55","5","3","1","2","8","27.59"
"138","Austin Watson","OTT","L","75","598.86666666667","6","2","1","1","8","61.54"
"146","Jarred Tinordi","CHI","D","44","639.48333333333","2","6","2","4","8","50.00"
"175","Joel Edmundson","MTL","D","61","948.15","2","6","1","5","8","22.22"
"440","Riley Stillman","BUF, VAN","D","50","677.05","1","7","2","5","8","26.67"
"461","Dylan Gambrell","OTT","C","60","544.83333333333","4","4","3","1","8","53.33"
"473","Mario Ferraro","S.J","D","72","1253.7666666667","2","6","1","5","8","19.05"
"490","Jack Studnicka","BOS, VAN","C","48","473.51666666667","4","4","1","3","8","100.00"
"492","MacKenzie Entwistle","CHI","R","66","677","3","5","1","4","8","47.06"
"512","Jan Rutta","PIT","D","56","802.31666666667","3","5","0","5","8","28.57"
"513","Gustav Lindstrom","DET","D","36","502.33333333333","1","7","3","4","8","57.14"
"554","Kevin Bahl","N.J","D","42","548.45","2","6","2","4","8","33.33"
"591","Philip Broberg","EDM","D","46","523.61666666667","1","7","2","5","8","27.59"
"607","Jake Neighbours","STL","L","43","477.13333333333","5","3","1","2","8","57.14"
"630","Juraj Slafkovsky","MTL","L","39","421.03333333333","3","5","1","4","8","80.00"
"631","Nick Blankenburg","CBJ","D","36","580.76666666667","3","5","3","2","8","34.78"
"28","Erik Johnson","COL","D","63","930.83333333333","0","7","4","3","7","19.44"
"246","Jayson Megna","ANA, COL","C","55","494.91666666667","2","5","2","3","7","70.00"
"256","Josh Brown","ARI","D","68","854.26666666667","4","3","2","1","7","18.92"
"274","Robert Hagg","DET","D","38","542.51666666667","2","5","4","1","7","38.89"
"451","Jacob MacDonald","COL, S.J","D","58","642.43333333333","1","6","3","3","7","41.18"
"453","Nikita Zaitsev","CHI, OTT","D","46","641.98333333333","1","6","2","4","7","30.43"
"474","Cal Foote","NSH, T.B","D","50","683.98333333333","2","5","2","3","7","23.33"
"504","Ian Mitchell","CHI","D","35","497.11666666667","1","6","2","4","7","38.89"
"517","Jacob Bryson","BUF","D","59","786.31666666667","1","6","3","3","7","28.00"
"559","Calen Addison","MIN","D","62","746.73333333333","3","4","1","3","7","25.93"
"594","Vasily Podkolzin","VAN","R","39","438.58333333333","4","3","2","1","7","53.85"
"597","Joel Kiviranta","DAL","L","70","725.65","6","1","0","1","7","53.85"
"620","Artem Zub","OTT","D","53","944.36666666667","1","6","1","5","7","20.00"
"626","Cole Sillinger","CBJ","C","64","734.6","1","6","4","2","7","35.00"
"151","Sam Carrick","ANA","C","52","494.46666666667","3","3","2","1","6","46.15"
"242","Ben Hutton","VGK","D","31","452.11666666667","2","4","2","2","6","37.50"
"266","Ben Harpur","NYR","D","42","576.78333333333","1","5","0","5","6","27.27"
"397","Kevin Stenlund","WPG","C","54","488.46666666667","3","3","1","2","6","42.86"
"401","Alexandre Carrier","NSH","D","43","630.03333333333","1","5","2","3","6","30.00"
"403","Niko Mikkola","NYR, STL","D","81","1238.65","1","5","2","3","6","11.11"
"421","Rasmus Asplund","BUF, NSH","C","46","452.35","1","5","1","4","6","42.86"
"500","Dylan Samberg","WPG","D","63","799.16666666667","2","4","1","3","6","20.69"
"562","Karson Kuhlman","SEA, WPG","C","47","495.93333333333","2","4","1","3","6","42.86"
"573","Reese Johnson","CHI","C","57","558.01666666667","4","2","1","1","6","42.86"
"592","Victor Soderstrom","ARI","D","30","434.55","0","6","2","4","6","35.29"
"18","Jack Johnson","CHI, COL","D","83","1375","2","3","1","2","5","13.16"
"53","Robert Bortuzzo","STL","D","43","454.55","2","3","2","1","5","22.73"
"63","Zach Bogosian","T.B","D","46","650.75","1","4","3","1","5","20.00"
"119","Matt Irwin","WSH","D","61","736.08333333333","2","3","1","2","5","22.73"
"248","Chad Ruhwedel","PIT","D","47","587.66666666667","1","4","1","3","5","23.81"
"293","Curtis Lazar","N.J, VAN","C","49","518.78333333333","3","2","1","1","5","35.71"
"547","Vitali Kravtsov","NYR, VAN","R","44","458.13333333333","3","2","0","2","5","38.46"
"50","Brendan Smith","N.J","D","60","822.15","0","4","1","3","4","13.79"
"108","Chris Wideman","MTL","D","46","555.33333333333","0","4","2","2","4","16.67"
"191","Nathan Beaulieu","ANA","D","52","668.81666666667","0","4","2","2","4","17.39"
"250","Kyle Burroughs","VAN","D","48","734.33333333333","2","2","2","0","4","19.05"
"399","Colton White","ANA","D","46","607.8","0","4","2","2","4","20.00"
"429","Kale Clague","BUF","D","33","484.06666666667","0","4","0","4","4","16.67"
"460","Vincent Desharnais","EDM","D","36","402.51666666667","0","4","3","1","4","20.00"
"544","Alexander Alexeyev","WSH","D","32","479.71666666667","0","4","2","2","4","20.00"
"632","Marcus Bjork","CBJ","D","33","486.83333333333","2","2","1","1","4","25.00"
"128","Patrik Nemeth","ARI","D","75","1067.0166666667","0","3","1","2","3","12.00"
"202","Luke Glendening","DAL","C","70","661.28333333333","1","2","0","2","3","30.00"
"325","Andreas Englund","CHI, COL","D","47","530.11666666667","0","3","2","1","3","21.43"
"511","Radim Simek","S.J","D","44","581.95","1","2","2","0","3","18.75"
"529","Parker Kelly","OTT","L","55","450.35","1","2","0","2","3","42.86"
"570","Tim Berni","CBJ","D","59","950.86666666667","1","2","1","1","3","9.68"
"13","Alex Goligoski","MIN","D","46","706.91666666667","0","2","2","0","2","9.52"
"44","Justin Braun","PHI","D","51","670.83333333333","0","2","2","0","2","9.09"
"95","Zack Kassian","ARI","R","51","461.55","2","0","0","0","2","40.00"