"","Player","Team","Position","GP","TOI","Goals","Total Assists","First Assists","Second Assists","Total Points","IPP"
"194","Johnny Gaudreau","CGY","L","82","1200.9666666667","26","46","37","9","72","75.00"
"466","Auston Matthews","TOR","C","73","1175.3833333333","38","28","16","12","66","75.00"
"464","Matthew Tkachuk","CGY","L","82","1181.7666666667","26","38","25","13","64","69.57"
"452","Kirill Kaprizov","MIN","L","81","1149.9166666667","25","37","26","11","62","83.78"
"435","Mitchell Marner","TOR","C, R","72","1054.9166666667","22","39","22","17","61","78.21"
"382","Michael Bunting","TOR","L","79","1095.05","21","37","22","15","58","65.91"
"402","Connor McDavid","EDM","C","80","1327.8166666667","22","36","24","12","58","79.45"
"83","Steven Stamkos","T.B","C","81","1072.1333333333","22","33","24","9","55","82.09"
"348","Leon Draisaitl","EDM","C","80","1284.7166666667","26","28","18","10","54","80.60"
"168","Vladimir Tarasenko","STL","R","75","976.56666666667","26","27","13","14","53","82.81"
"354","Kevin Fiala","MIN","L","82","1036.2","23","30","21","9","53","80.30"
"407","Timo Meier","S.J","R","77","1172.3166666667","20","33","18","15","53","82.81"
"545","Jason Robertson","DAL","L","74","1078.35","22","30","14","16","52","76.47"
"212","Jonathan Huberdeau","FLA","C, L","80","1009.15","17","33","19","14","50","76.92"
"309","Ryan Hartman","MIN","R","82","1119.8833333333","27","23","17","6","50","65.79"
"319","Nathan MacKinnon","COL","C","65","1034.0833333333","23","27","19","8","50","73.53"
"493","Jordan Kyrou","STL","C","74","1019.9666666667","22","28","22","6","50","83.33"
"501","Jesper Bratt","N.J","L","76","1033.1166666667","21","29","15","14","50","83.33"
"69","Patrick Kane","CHI","R","78","1298","15","34","23","11","49","75.38"
"297","Jake Guentzel","PIT","L","76","1156.8833333333","25","24","15","9","49","77.78"
"543","Robert Thomas","STL","C","72","1001.4166666667","12","37","24","13","49","69.01"
"15","Joe Pavelski","DAL","C","82","1162.4666666667","14","34","20","14","48","72.73"
"17","Alex Ovechkin","WSH","L","77","1128.55","24","24","14","10","48","73.85"
"94","Roman Josi","NSH","D","80","1570.5666666667","10","38","23","15","48","58.54"
"122","Nazem Kadri","COL","C","71","963.71666666667","16","32","22","10","48","80.00"
"305","Andre Burakovsky","COL","L","80","1100.8833333333","18","30","18","12","48","68.57"
"445","Artemi Panarin","NYR","L","75","1136.1833333333","13","35","23","12","48","85.71"
"118","Matt Duchene","NSH","C","78","1123.65","21","26","15","11","47","69.12"
"172","Jeff Skinner","BUF","L","80","1088.15","25","22","19","3","47","74.60"
"221","J.T. Miller","VAN","C","80","1152.4833333333","19","28","12","16","47","81.03"
"323","Elias Lindholm","CGY","C","82","1144.3166666667","25","22","11","11","47","55.29"
"355","Dylan Larkin","DET","C","71","1059.7333333333","22","25","17","8","47","81.03"
"450","Conor Garland","VAN","R","77","1075.6666666667","17","30","20","10","47","79.66"
"300","Carter Verhaeghe","FLA","C","78","1076.0666666667","21","25","14","11","46","77.97"
"399","Kyle Connor","WPG","L","79","1241.15","28","18","10","8","46","83.64"
"409","Mikko Rantanen","COL","R","75","1172.4833333333","17","29","17","12","46","54.12"
"505","Tage Thompson","BUF","R","78","1044.1","24","22","12","10","46","70.77"
"250","Filip Forsberg","NSH","L","69","932.31666666667","26","19","12","7","45","77.59"
"367","Ivan Barbashev","STL","C","81","1089.5666666667","17","28","19","9","45","75.00"
"277","Alexander Kerfoot","TOR","C","82","1055.5","11","32","16","16","43","68.25"
"347","Sam Reinhart","FLA","C","78","1006","14","29","19","10","43","68.25"
"364","David Pastrnak","BOS","R","72","992.88333333333","22","21","16","5","43","70.49"
"555","Cale Makar","COL","D","77","1464.3833333333","13","30","16","14","43","49.43"
"41","Brad Marchand","BOS","L","70","908.08333333333","18","24","14","10","42","80.77"
"151","Mats Zuccarello","MIN","C, R","70","983.83333333333","16","26","19","7","42","67.74"
"256","Chandler Stephenson","VGK","C","79","1137.7166666667","11","31","12","19","42","68.85"
"455","Troy Terry","ANA","C, R","75","1122.3166666667","23","19","9","10","42","77.78"
"296","Pavel Buchnevich","STL","L","73","983.71666666667","15","26","10","16","41","65.08"
"416","Travis Konecny","PHI","C, R","79","1082.1166666667","12","29","22","7","41","78.85"
"476","Clayton Keller","ARI","C, R","67","999.91666666667","18","23","14","9","41","73.21"
"579","Brady Tkachuk","OTT","L","79","1133.7833333333","15","26","20","6","41","73.21"
"175","Taylor Hall","BOS","L","81","1037.1166666667","10","30","19","11","40","67.80"
"224","Phillip Danault","L.A","C, L","79","1049.7666666667","24","16","7","9","40","75.47"
"351","William Nylander","TOR","C, R","81","1124.3","18","22","19","3","40","72.73"
"360","Nick Schmaltz","ARI","C","63","900.15","14","26","21","5","40","76.92"
"461","Mason Marchment","FLA","L","54","701.43333333333","15","25","11","14","40","78.43"
"610","Trevor Zegras","ANA","C","75","1066.2333333333","12","28","17","11","40","80.00"
"26","Sidney Crosby","PIT","C","69","1049.9833333333","15","24","16","8","39","70.91"
"116","John Tavares","TOR","C","79","1112.1833333333","15","24","11","13","39","68.42"
"215","Mika Zibanejad","NYR","C","81","1101.75","12","27","18","9","39","70.91"
"247","Tomas Hertl","S.J","C","82","1189.25","18","21","14","7","39","65.00"
"352","Nikolaj Ehlers","WPG","L","62","911.41666666667","20","19","14","5","39","70.91"
"473","Alex DeBrincat","CHI","L","82","1256.6666666667","18","21","10","11","39","66.10"
"216","Mark Scheifele","WPG","C","67","1084.5333333333","17","21","12","9","38","69.09"
"316","Tyler Bertuzzi","DET","L","68","1018.3333333333","18","20","10","10","38","71.70"
"320","Aleksander Barkov","FLA","C","67","884.73333333333","15","23","14","9","38","70.37"
"411","Sebastian Aho","CAR","C, R","79","999.9","15","23","15","8","38","73.08"
"536","Nico Hischier","N.J","C","70","958.53333333333","13","25","16","9","38","80.85"
"588","Andrei Svechnikov","CAR","R","78","1030.8","16","22","15","7","38","69.09"
"105","Cam Atkinson","PHI","R","73","924.03333333333","16","21","17","4","37","74.00"
"117","Victor Hedman","T.B","D","82","1470.45","11","26","11","15","37","48.05"
"144","Erik Haula","BOS","L","78","991.65","15","22","12","10","37","71.15"
"158","Evgeny Kuznetsov","WSH","C","79","1118.1","13","24","14","10","37","66.07"
"180","Nino Niederreiter","CAR","R","75","979.11666666667","18","19","11","8","37","62.71"
"239","Brady Skjei","CAR","D","82","1436.2333333333","9","28","16","12","37","51.39"
"395","Andrew Mangiapane","CGY","L","82","989.93333333333","23","14","8","6","37","75.51"
"421","Roope Hintz","DAL","C, L","80","1059.4","24","13","11","2","37","61.67"
"55","Alex Killorn","T.B","C, L","82","1044.35","14","22","12","10","36","75.00"
"162","Justin Faulk","STL","D","76","1425.6166666667","13","23","7","16","36","39.56"
"163","Brock Nelson","NYI","C","72","970.01666666667","21","15","11","4","36","75.00"
"173","Zach Hyman","EDM","C, L","76","1098.0333333333","19","17","13","4","36","76.60"
"228","Jonathan Marchessault","VGK","C","76","1097.7","18","18","14","4","36","76.60"
"236","Morgan Rielly","TOR","D","82","1474.5166666667","7","29","17","12","36","40.00"
"328","Valeri Nichushkin","COL","R","62","866.43333333333","15","21","13","8","36","67.92"
"33","Kris Letang","PIT","D","78","1505.6","6","29","18","11","35","49.30"
"209","Nikita Kucherov","T.B","R","47","704.93333333333","14","21","14","7","35","70.00"
"379","Viktor Arvidsson","L.A","L","66","892.08333333333","12","23","15","8","35","76.09"
"420","Mathew Barzal","NYI","C","73","1040.5333333333","12","23","13","10","35","77.78"
"424","Jack Roslovic","CBJ","C","81","939.55","17","18","12","6","35","72.92"
"28","Anze Kopitar","L.A","C","81","1179.4166666667","12","22","14","8","34","73.91"
"49","Claude Giroux","FLA, PHI","C, R","75","1034.2833333333","13","21","9","12","34","72.34"
"214","Ryan Strome","NYR","C","74","1039.7833333333","11","23","13","10","34","61.82"
"343","Frederick Gaudreau","MIN","C","76","905.81666666667","12","22","11","11","34","69.39"
"474","Patrik Laine","CBJ","L","56","805.88333333333","14","20","10","10","34","80.95"
"520","Trevor Moore","L.A","C","81","1029.8333333333","8","26","16","10","34","72.34"
"542","Nick Suzuki","MTL","C","82","1209.7666666667","9","25","12","13","34","72.34"
"629","Lucas Raymond","DET","L","82","1172.2666666667","16","18","8","10","34","65.38"
"13","Patrice Bergeron","BOS","C","73","891.18333333333","14","19","10","9","33","67.35"
"52","Phil Kessel","ARI","C, R","82","1077.75","5","28","15","13","33","66.00"
"190","Ondrej Palat","T.B","L","77","1016.1166666667","14","19","11","8","33","62.26"
"233","Yanni Gourde","SEA","C","74","1028.3833333333","14","19","16","3","33","78.57"
"299","Anthony Duclair","FLA","L","74","879.83333333333","18","15","13","2","33","57.89"
"378","Devon Toews","COL","D","66","1291.5166666667","7","26","7","19","33","41.77"
"498","Pierre-Luc Dubois","WPG","L","81","1190.35","9","24","14","10","33","62.26"
"20","Blake Wheeler","WPG","R","65","973.2","12","20","14","6","32","74.42"
"25","Paul Stastny","WPG","C","71","987.8","14","18","11","7","32","60.38"
"91","Jordan Eberle","SEA","C, R","79","1114.2666666667","16","16","9","7","32","68.09"
"113","Ryan O'Reilly","STL","C","78","1053.0833333333","9","23","14","9","32","69.57"
"127","Chris Kreider","NYR","L","81","1075.3666666667","20","12","7","5","32","65.31"
"136","Craig Smith","BOS","C","74","920.4","16","16","11","5","32","72.73"
"211","Gabriel Landeskog","COL","L","51","767.85","16","16","10","6","32","66.67"
"257","Shayne Gostisbehere","ARI","D","82","1420.55","12","20","8","12","32","55.17"
"287","Andreas Johnsson","N.J","L","71","909.18333333333","11","21","18","3","32","61.54"
"301","Oliver Bjorkstrand","CBJ","R","80","1098.45","16","16","13","3","32","78.05"
"303","Andrew Copp","NYR, WPG","C","72","991.81666666667","14","18","8","10","32","69.57"
"337","Conor Sheary","WSH","L","71","893.6","14","18","10","8","32","82.05"
"349","Sam Bennett","FLA","C","71","930.06666666667","19","13","10","3","32","55.17"
"388","Victor Olofsson","BUF","L","72","902.18333333333","10","22","14","8","32","80.00"
"417","Dylan Strome","CHI","C","69","977.86666666667","17","15","9","6","32","69.57"
"467","Adam Fox","NYR","D","78","1367.9666666667","8","24","11","13","32","51.61"
"551","Martin Necas","CAR","C","78","973.08333333333","10","22","15","7","32","68.09"
"601","Yegor Sharangovich","N.J","C","76","1023.1833333333","16","16","11","5","32","59.26"
"617","Jack Hughes","N.J","C","49","749.96666666667","16","16","10","6","32","74.42"
"630","Seth Jarvis","CAR","C","68","821.05","14","18","10","8","32","66.67"
"632","Dawson Mercer","N.J","C","82","1124.9","14","18","16","2","32","55.17"
"71","Evgenii Dadonov","VGK","R","78","1006.05","12","19","15","4","31","62.00"
"120","Brayden Schenn","STL","C","62","865.76666666667","13","18","13","5","31","64.58"
"197","Vincent Trocheck","CAR","C","81","992.21666666667","11","20","9","11","31","64.58"
"314","Artturi Lehkonen","COL, MTL","L","74","869.35","14","17","12","5","31","83.78"
"329","Max Domi","CAR, CBJ","C","72","828.33333333333","9","22","15","7","31","67.39"
"438","Jake DeBrusk","BOS","L","77","952.43333333333","17","14","8","6","31","77.50"
"513","Ross Colton","T.B","C","79","864.23333333333","20","11","7","4","31","81.58"
"519","Tanner Jeannot","NSH","L","81","993.45","17","14","8","6","31","77.50"
"581","Evan Bouchard","EDM","D","81","1306.1333333333","9","22","10","12","31","50.00"
"87","Josh Bailey","NYI","C, R","74","988.15","12","18","11","7","30","71.43"
"101","Gustav Nyquist","CBJ","C","82","1097.0666666667","9","21","14","7","30","50.85"
"200","Blake Coleman","CGY","C","81","1025.6","15","15","8","7","30","71.43"
"204","Boone Jenner","CBJ","C","59","876.75","14","16","8","8","30","69.77"
"246","Tom Wilson","WSH","R","78","1061.6333333333","14","16","7","9","30","52.63"
"371","Ryan Donato","SEA","C","74","862.36666666667","15","15","11","4","30","75.00"
"375","Brayden Point","T.B","C","66","953.8","15","15","10","5","30","52.63"
"510","Rem Pitlick","MIN, MTL","C","66","799.3","12","18","11","7","30","68.18"
"633","Anton Lundell","FLA","C","65","790.1","13","17","10","7","30","52.63"
"72","Mikael Backlund","CGY","C","82","1063.1833333333","10","19","14","5","29","60.42"
"75","Jakub Voracek","CBJ","R","79","1050.0666666667","2","27","24","3","29","63.04"
"135","Marcus Foligno","MIN","L","74","892.6","14","15","12","3","29","63.04"
"176","Ryan Johansen","NSH","C","79","940.11666666667","11","18","4","14","29","59.18"
"177","Tyler Seguin","DAL","C","81","1129.8833333333","17","12","10","2","29","78.38"
"179","Mikael Granlund","NSH","C","80","1104.5166666667","7","22","12","10","29","55.77"
"192","Travis Boyd","ARI","C","74","997.21666666667","14","15","9","6","29","54.72"
"206","Brandon Saad","STL","L","78","1024.5","13","16","9","7","29","63.04"
"226","Rickard Rakell","ANA, PIT","L, R","70","1027.6","14","15","8","7","29","53.70"
"249","Jacob Trouba","NYR","D","81","1463.0333333333","8","21","12","9","29","43.94"
"269","Jaccob Slavin","CAR","D","79","1386.35","3","26","10","16","29","39.19"
"288","MacKenzie Weegar","FLA","D","80","1488.0833333333","5","24","13","11","29","33.33"
"307","Shea Theodore","VGK","D","78","1484.05","7","22","12","10","29","43.28"
"346","Aaron Ekblad","FLA","D","61","1050.9166666667","10","19","5","14","29","43.28"
"363","Jared McCann","SEA","C, L","74","917.18333333333","17","12","7","5","29","78.38"
"381","Danton Heinen","PIT","L","76","865.33333333333","15","14","10","4","29","64.44"
"397","Noah Hanifin","CGY","D","81","1353.5","8","21","5","16","29","39.19"
"444","Evan Rodrigues","PIT","C","82","1056.95","9","20","12","8","29","65.91"
"526","Kailer Yamamoto","EDM","R","81","1174.55","14","15","9","6","29","53.70"
"540","Elias Pettersson","VAN","C","80","1089.0833333333","16","13","6","7","29","69.05"
"571","Pius Suter","DET","C","82","1066.8833333333","14","15","9","6","29","69.05"
"576","Joel Farabee","PHI","L","63","802.35","14","15","9","6","29","67.44"
"616","Matt Boldy","MIN","L","47","580.05","12","17","10","7","29","69.05"
"44","Kyle Okposo","BUF","R","74","956.11666666667","11","17","7","10","28","84.85"
"50","Jordan Staal","CAR","C","78","987.61666666667","13","15","7","8","28","60.87"
"62","James van Riemsdyk","PHI","L","82","1049.4833333333","15","13","7","6","28","68.29"
"99","Adam Henrique","ANA","C","58","824.01666666667","11","17","10","7","28","63.64"
"145","Anders Lee","NYI","C, L","76","1015.8","17","11","4","7","28","53.85"
"181","Bryan Rust","PIT","R","60","817.75","10","18","11","7","28","66.67"
"243","Mike Matheson","PIT","D","74","1264.5833333333","11","17","8","9","28","43.75"
"396","Frank Vatrano","FLA, NYR","C","71","853.65","15","13","10","3","28","77.78"
"426","Nicolas Roy","VGK","C","78","982.81666666667","13","15","12","3","28","57.14"
"514","Brandon Hagel","CHI, T.B","L","77","988.85","16","12","9","3","28","66.67"
"553","Josh Norris","OTT","C","66","900.25","16","12","6","6","28","62.22"
"637","Alexander Barabanov","S.J","L","70","1016.2333333333","6","22","13","9","28","60.87"
"9","Brent Burns","S.J","D","82","1567.15","6","21","10","11","27","39.71"
"54","Jonathan Toews","CHI","C","71","883.21666666667","7","20","13","7","27","65.85"
"68","David Perron","STL","L","67","909.31666666667","12","15","6","9","27","79.41"
"129","Reilly Smith","VGK","R","56","739.9","11","16","9","7","27","77.14"
"159","Charlie Coyle","BOS","C","82","1026.95","10","17","11","6","27","62.79"
"253","Colton Parayko","STL","D","80","1595.0333333333","4","23","7","16","27","33.75"
"302","Nicholas Paul","OTT, T.B","L","80","1065.85","13","14","4","10","27","72.97"
"322","Seth Jones","CHI","D","78","1525.3333333333","5","22","7","15","27","52.94"
"357","Travis Sanheim","PHI","D","80","1531.4333333333","6","21","11","10","27","34.62"
"370","Brandon Montour","FLA","D","81","1237.2833333333","9","18","6","12","27","39.13"
"384","Gustav Forsling","FLA","D","71","1241.2666666667","8","19","10","9","27","35.53"
"578","Quinn Hughes","VAN","D","76","1444.25","7","20","12","8","27","45.00"
"589","Rasmus Dahlin","BUF","D","80","1517.7333333333","9","18","10","8","27","45.76"
"625","Alex Newhook","COL","C","71","841.98333333333","10","17","9","8","27","79.41"
"631","Alexis Lafrenière","NYR","L","79","976.83333333333","18","9","4","5","27","69.23"
"5","Jeff Carter","PIT","C","76","996.46666666667","11","15","7","8","26","68.42"
"11","Corey Perry","T.B","R","82","931.6","8","18","14","4","26","70.27"
"93","John Carlson","WSH","D","78","1296.1833333333","5","21","14","7","26","44.07"
"112","Kyle Palmieri","NYI","C, R","69","901.7","13","13","7","6","26","59.09"
"132","Dmitry Orlov","WSH","D","76","1387.6333333333","9","17","12","5","26","40.63"
"186","Jesper Fast","CAR","R","82","1032.7","12","14","10","4","26","49.06"
"240","Tanner Pearson","VAN","L","68","898.8","11","15","7","8","26","63.41"
"263","Damon Severson","N.J","D","80","1393.7166666667","6","20","11","9","26","44.83"
"272","Josh Anderson","MTL","R","69","998.58333333333","14","12","6","6","26","66.67"
"275","Connor Brown","OTT","R","64","911.85","9","17","11","6","26","70.27"
"331","Alex Wennberg","SEA","C","80","1116.3333333333","8","18","11","7","26","65.00"
"389","Pierre Engvall","TOR","L","78","892.85","10","16","11","5","26","78.79"
"443","Anthony Cirelli","T.B","C","76","1036.4166666667","10","16","11","5","26","57.78"
"502","Mikhail Sergachev","T.B","D","78","1378.4333333333","5","21","11","10","26","41.27"
"567","Drake Batherson","OTT","R","46","667.26666666667","12","14","9","5","26","74.29"
"64","Logan Couture","S.J","C","77","1024","11","14","10","4","25","65.79"
"119","Evander Kane","EDM","L","43","681.16666666667","12","13","5","8","25","64.10"
"150","Christopher Tanev","CGY","D","82","1363.75","5","20","10","10","25","35.71"
"201","Jean-Gabriel Pageau","NYI","C","77","963.3","12","13","6","7","25","65.79"
"229","Barclay Goodrow","NYR","C","79","1040.8833333333","10","15","10","5","25","55.56"
"327","Bo Horvat","VAN","C","70","972.2","12","13","11","2","25","67.57"
"358","Alex Tuch","BUF","R","50","658.85","7","18","11","7","25","60.98"
"359","Tony DeAngelo","CAR","D","64","999.13333333333","8","17","10","7","25","38.46"
"365","Adrian Kempe","L.A","C, L","78","1027.1666666667","17","8","3","5","25","64.10"
"391","Jake Evans","MTL","C","72","915.55","11","14","9","5","25","64.10"
"398","Rasmus Andersson","CGY","D","82","1381.2166666667","2","23","13","10","25","33.33"
"436","Joel Eriksson Ek","MIN","C","77","931.55","11","14","8","6","25","55.56"
"457","Vladislav Gavrikov","CBJ","D","80","1466.45","4","21","10","11","25","36.23"
"469","Charlie McAvoy","BOS","D","78","1383.9","3","22","7","15","25","33.78"
"477","Jesse Puljujarvi","EDM","R","65","928.31666666667","9","16","9","7","25","49.02"
"506","Filip Hronek","DET","D","78","1346.05","2","23","12","11","25","47.17"
"547","Alex Formenton","OTT","L","79","966.78333333333","12","13","7","6","25","75.76"
"559","Alex Iafallo","L.A","L","79","1050.1666666667","11","14","6","8","25","64.10"
"587","Jesperi Kotkaniemi","CAR","C","66","706.98333333333","12","13","5","8","25","75.76"
"593","Noah Dobson","NYI","D","80","1355.8","8","17","12","5","25","43.86"
"609","Dylan Cozens","BUF","C","79","1026.85","11","14","5","9","25","65.79"
"634","Tim Stützle","OTT","L","79","1096.15","11","14","9","5","25","60.98"
"56","Jamie Benn","DAL","L","82","1043.4","9","15","7","8","24","64.86"
"79","Lars Eller","WSH","C","72","896.13333333333","11","13","11","2","24","60.00"
"102","Derek Grant","ANA","C","71","793.48333333333","11","13","8","5","24","82.76"
"208","William Karlsson","VGK","C","67","918.65","8","16","10","6","24","68.57"
"241","Scott Laughton","PHI","C","67","898.46666666667","8","16","7","9","24","70.59"
"304","Ryan Graves","N.J","D","75","1316.4","6","18","11","7","24","38.71"
"356","Sonny Milano","ANA","L","66","837.45","9","15","11","4","24","72.73"
"386","Oskar Lindblom","PHI","L","79","961.51666666667","11","13","7","6","24","64.86"
"401","Pavel Zacha","N.J","C","70","929.41666666667","8","16","9","7","24","60.00"
"412","Oliver Kylington","CGY","D","73","1193.6166666667","6","18","6","12","24","35.29"
"433","Lawson Crouse","ARI","L","65","843.58333333333","15","9","6","3","24","66.67"
"612","Cole Caufield","MTL","R","67","874","15","9","5","4","24","58.54"
"641","Cole Sillinger","CBJ","C","79","942.93333333333","14","10","6","4","24","70.59"
"7","Zach Parise","NYI","L","82","947.25","9","14","10","4","23","58.97"
"100","TJ Brodie","TOR","D","82","1475.05","4","19","10","9","23","32.86"
"130","Tomas Tatar","N.J","L","76","942.8","12","11","5","6","23","65.71"
"187","John Klingberg","DAL","D","74","1323.1166666667","3","20","12","8","23","42.59"
"225","Vladislav Namestnikov","DAL, DET","C","75","920.21666666667","12","11","5","6","23","63.89"
"248","Teuvo Teravainen","CAR","L","77","932.65","10","13","9","4","23","50.00"
"259","Adam Pelech","NYI","D","78","1377.4833333333","2","21","10","11","23","37.70"
"265","Teddy Blueger","PIT","C","65","795.78333333333","7","16","6","10","23","67.65"
"362","Kasperi Kapanen","PIT","R","79","978.58333333333","11","12","8","4","23","62.16"
"369","Nicolas Aube-Kubel","COL, PHI","R","74","716.83333333333","11","12","9","3","23","76.67"
"372","Christian Dvorak","MTL","L","56","699.71666666667","9","14","9","5","23","76.67"
"427","Anthony Beauvillier","NYI","L","75","1045.2","7","16","12","4","23","56.10"
"479","Dillon Dube","CGY","C","79","866.9","13","10","5","5","23","65.71"
"487","Dante Fabbro","NSH","D","66","1127.9333333333","2","21","11","10","23","41.07"
"624","Vasily Podkolzin","VAN","R","79","940.45","12","11","9","2","23","57.50"
"6","Dustin Brown","L.A","L, R","64","783.95","7","15","7","8","22","78.57"
"38","Anton Stralman","ARI","D","74","1301.45","7","15","7","8","22","36.67"
"73","Ryan McDonagh","T.B","D","71","1265.75","4","18","7","11","22","41.51"
"166","Kevin Hayes","PHI","C, R","48","643","6","16","8","8","22","73.33"
"188","Mark Stone","VGK","R","37","513.56666666667","5","17","12","5","22","73.33"
"274","Vinnie Hinostroza","BUF","C","62","807.51666666667","11","11","7","4","22","75.86"
"374","Warren Foegele","EDM","L","82","954.65","9","13","9","4","22","59.46"
"425","Zach Werenski","CBJ","D","68","1317.25","6","16","7","9","22","43.14"
"431","Thomas Chabot","OTT","D","59","1242.2333333333","6","16","6","10","22","36.67"
"432","Mathieu Joseph","OTT, T.B","R","69","797.63333333333","8","14","6","8","22","64.71"
"437","Denis Gurianov","DAL","R","73","868.93333333333","6","16","10","6","22","64.71"
"573","Eric Robinson","CBJ","L","67","758.08333333333","7","15","9","6","22","84.62"
"582","Isac Lundestrom","ANA","C","80","981.91666666667","11","11","7","4","22","70.97"
"613","Moritz Seider","DET","D","82","1395.4","2","20","9","11","22","34.38"
"619","Philip Tomasino","NSH","C","76","756.53333333333","8","14","12","2","22","66.67"
"8","Ryan Getzlaf","ANA","C","56","815.08333333333","1","20","11","9","21","75.00"
"63","Sam Gagner","DET","C","81","829.03333333333","8","13","10","3","21","63.64"
"74","Max Pacioretty","VGK","L","39","534.66666666667","14","7","2","5","21","72.41"
"106","Jared Spurgeon","MIN","D","65","956.98333333333","7","14","7","7","21","37.50"
"196","Sean Kuraly","CBJ","C","77","986.71666666667","10","11","2","9","21","47.73"
"213","Adam Larsson","SEA","D","82","1538.8833333333","7","14","9","5","21","38.89"
"231","Torey Krug","STL","D","64","1061.9166666667","4","17","9","8","21","31.34"
"245","Cody Ceci","EDM","D","78","1375.15","5","16","6","10","21","37.50"
"318","Brett Pesce","CAR","D","70","1206.9833333333","4","17","6","11","21","35.59"
"333","Nikita Zadorov","CGY","D","74","1162.9","3","18","8","10","21","46.67"
"342","Garnet Hathaway","WSH","R","76","889.35","11","10","3","7","21","55.26"
"404","Vince Dunn","SEA","D","73","1266.7833333333","5","16","6","10","21","41.18"
"415","Keegan Kolesar","VGK","R","77","879.1","5","16","11","5","21","63.64"
"447","Derek Ryan","EDM","C","75","710.55","10","11","6","5","21","63.64"
"532","Michael Rasmussen","DET","C","80","940.66666666667","13","8","5","3","21","63.64"
"537","Jesper Boqvist","N.J","C","56","681.18333333333","9","12","6","6","21","77.78"
"550","Miro Heiskanen","DAL","D","70","1345.9666666667","1","20","9","11","21","42.00"
"565","Eetu Luostarinen","FLA","C","78","868.75","6","15","8","7","21","65.63"
"638","Artem Zub","OTT","D","81","1462.1166666667","6","15","6","9","21","41.18"
"22","Alex Goligoski","MIN","D","72","1113.9","2","18","7","11","20","24.69"
"48","Jeff Petry","MTL","D","68","1155.1166666667","6","14","6","8","20","38.46"
"61","Pat Maroon","T.B","L","81","889.35","8","12","6","6","20","54.05"
"65","P.K. Subban","N.J","D","77","1252.6166666667","5","15","7","8","20","34.48"
"89","Erik Karlsson","S.J","D","50","890.66666666667","7","13","6","7","20","50.00"
"92","Tyler Ennis","OTT","C, R","57","608.65","7","13","10","3","20","86.96"
"125","Dmitry Kulikov","MIN","D","80","1239.7666666667","5","15","9","6","20","31.25"
"134","Mattias Ekholm","NSH","D","76","1311.6166666667","5","15","6","9","20","30.77"
"152","Calle Jarnkrok","CGY, SEA","C","66","797.3","8","12","3","9","20","62.50"
"155","Tyler Toffoli","CGY, MTL","C, R","74","887.91666666667","6","14","9","5","20","68.97"
"210","Ryan Nugent-Hopkins","EDM","C","63","820.7","6","14","9","5","20","52.63"
"266","Jake McCabe","CHI","D","75","1278.6","3","17","7","10","20","41.67"
"267","Brock McGinn","PIT","L","64","809.35","10","10","7","3","20","76.92"
"285","Dominik Kubalik","CHI","L","78","972.35","10","10","1","9","20","64.52"
"298","Mattias Janmark","VGK","C","67","828.01666666667","6","14","6","8","20","62.50"
"315","William Carrier","VGK","L","63","707.25","9","11","5","6","20","57.14"
"325","Darnell Nurse","EDM","D","71","1397.55","6","14","7","7","20","33.90"
"361","Robby Fabbri","DET","C","56","761.23333333333","10","10","7","3","20","68.97"
"406","Jordan Greenway","MIN","L","62","753.41666666667","6","14","5","9","20","46.51"
"419","Brock Boeser","VAN","R","71","1025.3","9","11","4","7","20","57.14"
"442","Yakov Trenin","NSH","C","80","1000.6166666667","13","7","3","4","20","60.61"
"465","Luke Kunin","NSH","C","82","952.15","13","7","5","2","20","58.82"
"497","Samuel Girard","COL","D","67","1227.4833333333","4","16","7","9","20","32.79"
"552","Timothy Liljegren","TOR","D","61","892.73333333333","4","16","5","11","20","35.09"
"558","Filip Chytil","NYR","C","67","788.55","8","12","7","5","20","68.97"
"10","Brian Boyle","PIT","C","66","572.58333333333","10","9","4","5","19","82.61"
"39","Patric Hornqvist","FLA","R","65","667.3","8","11","4","7","19","63.33"
"43","Erik Johnson","COL","D","77","1059.0333333333","6","13","6","7","19","33.33"
"60","Kevin Shattenkirk","ANA","D","82","1356.4666666667","6","13","9","4","19","36.54"
"84","Alex Pietrangelo","VGK","D","80","1483.8","7","12","6","6","19","28.79"
"97","Derek Stepan","CAR","C","58","561.28333333333","9","10","6","4","19","76.00"
"146","Nick Jensen","WSH","D","76","1247.7166666667","5","14","7","7","19","29.23"
"147","Nic Dowd","WSH","C","64","757.11666666667","9","10","8","2","19","65.52"
"153","Justin Holl","TOR","D","69","1166.3666666667","2","17","5","12","19","33.33"
"161","Jon Merrill","MIN","D","69","1020.4","4","15","6","9","19","33.33"
"167","Cam Fowler","ANA","D","76","1379.8","2","17","6","11","19","31.15"
"218","Dougie Hamilton","N.J","D","62","1049.3333333333","6","13","5","8","19","32.76"
"235","Alex Galchenyuk","ARI","C","60","725.76666666667","5","14","7","7","19","63.33"
"254","Oskar Sundqvist","DET, STL","C","59","667.3","7","12","9","3","19","55.88"
"264","Colton Sissons","NSH","C","79","970.8","5","14","5","9","19","59.38"
"335","Anthony Mantha","WSH","R","37","468.7","7","12","10","2","19","67.86"
"353","Nick Ritchie","ARI, TOR","L","57","634.58333333333","11","8","3","5","19","76.00"
"413","Evgeny Svechnikov","WPG","L","72","763.96666666667","7","12","5","7","19","73.08"
"439","Ivan Provorov","PHI","D","79","1478.2833333333","7","12","3","9","19","33.33"
"441","John Marino","PIT","D","81","1338.3666666667","1","18","7","11","19","39.58"
"454","Rudolfs Balcers","S.J","L","61","803.3","10","9","5","4","19","61.29"
"560","David Kampf","TOR","C","82","1007","8","11","6","5","19","50.00"
"603","Logan O'Connor","COL","R","81","925.2","7","12","8","4","19","57.58"
"605","Blake Lizotte","L.A","C","70","745.85","8","11","7","4","19","59.38"
"626","Ilya Mikheyev","TOR","R","53","645.91666666667","11","8","6","2","19","59.38"
"4","Ryan Suter","DAL","D","82","1546.0166666667","3","15","4","11","18","30.51"
"16","Mark Giordano","SEA, TOR","D","75","1176.4666666667","3","15","8","7","18","35.29"
"18","Evgeni Malkin","PIT","C","41","555.86666666667","10","8","3","5","18","78.26"
"58","Ian Cole","CAR","D","75","1071.7833333333","2","16","6","10","18","40.00"
"109","Mike Hoffman","MTL","C","67","894.63333333333","10","8","5","3","18","58.06"
"111","Marcus Johansson","SEA, WSH","L","69","881.86666666667","6","12","8","4","18","54.55"
"121","Oliver Ekman-Larsson","VAN","D","79","1387.7166666667","2","16","9","7","18","32.73"
"143","Ben Chiarot","FLA, MTL","D","74","1334.05","6","12","8","4","18","36.00"
"182","Joonas Donskoi","SEA","R","75","845.6","2","16","4","12","18","64.29"
"252","Matt Grzelcyk","BOS","D","73","1176.75","3","15","6","9","18","28.57"
"270","Brett Kulak","EDM, MTL","D","74","1185.7166666667","5","13","5","8","18","35.29"
"282","Nate Schmidt","WPG","D","77","1306.9166666667","2","16","9","7","18","38.30"
"311","J.T. Compher","COL","L","70","843.21666666667","11","7","4","3","18","51.43"
"330","Josh Morrissey","WPG","D","79","1478.8166666667","5","13","9","4","18","30.00"
"368","Marcus Pettersson","PIT","D","72","1064.6666666667","2","16","11","5","18","42.86"
"377","Michael Amadio","TOR, VGK","C","56","663.41666666667","11","7","4","3","18","64.29"
"390","Ondrej Kase","TOR","R","50","571.61666666667","9","9","4","5","18","85.71"
"449","Alexandre Carrier","NSH","D","77","1235.3666666667","1","17","7","10","18","32.73"
"471","Rasmus Asplund","BUF","C","80","974.43333333333","2","16","12","4","18","52.94"
"484","Trent Frederic","BOS","C","60","651.93333333333","8","10","9","1","18","69.23"
"496","Noah Gregor","S.J","C","63","810.61666666667","8","10","5","5","18","72.00"
"499","Jake Bean","CBJ","D","67","1178.7333333333","5","13","4","9","18","34.62"
"530","Morgan Geekie","SEA","C","73","791.25","7","11","6","5","18","69.23"
"561","Neal Pionk","WPG","D","77","1313.7333333333","1","17","9","8","18","31.03"
"563","Jan Rutta","T.B","D","76","1121.5166666667","3","15","5","10","18","28.57"
"572","Zach Whitecloud","VGK","D","59","983.25","7","11","8","3","18","32.73"
"607","Kirby Dach","CHI","C","70","986.21666666667","7","11","7","4","18","48.65"
"3","Duncan Keith","EDM","D","64","1065.1333333333","1","16","9","7","17","32.69"
"12","Loui Eriksson","ARI","L","73","819.66666666667","2","15","8","7","17","62.96"
"46","Milan Lucic","CGY","L","82","898.18333333333","8","9","5","4","17","65.38"
"57","Nick Bonino","S.J","C","80","1004.6666666667","11","6","4","2","17","58.62"
"59","Justin Braun","NYR, PHI","D","69","1162.45","6","11","4","7","17","42.50"
"95","Justin Schultz","WSH","D","74","1102.4833333333","2","15","9","6","17","39.53"
"131","Tyson Barrie","EDM","D","73","1100.1833333333","4","13","8","5","17","31.48"
"148","Brenden Dillon","WPG","D","79","1301.5833333333","2","15","5","10","17","30.36"
"156","Johan Larsson","ARI, WSH","L","43","559.88333333333","4","13","4","9","17","65.38"
"174","Erik Gudbranson","CGY","D","78","1161.6833333333","6","11","5","6","17","34.00"
"184","Sam Carrick","ANA","C","64","656.61666666667","9","8","2","6","17","85.00"
"199","Nick Cousins","NSH","C","68","717.43333333333","5","12","6","6","17","70.83"
"205","Victor Rask","MIN, SEA","C","47","521.3","7","10","5","5","17","68.00"
"207","Matt Nieto","S.J","L","70","853.41666666667","6","11","8","3","17","68.00"
"237","Hampus Lindholm","ANA, BOS","D","71","1287.3166666667","4","13","6","7","17","30.36"
"238","Matt Dumba","MIN","D","57","1014.75","5","12","7","5","17","41.46"
"344","Pierre-Edouard Bellemare","T.B","L","80","866.56666666667","8","9","4","5","17","47.22"
"428","Daniel Sprong","SEA, WSH","R","63","726.81666666667","12","5","3","2","17","56.67"
"462","Ryan Lomberg","FLA","L","55","554.18333333333","9","8","3","5","17","65.38"
"481","Sam Steel","ANA","C","68","763.01666666667","6","11","5","6","17","68.00"
"482","Brett Howden","VGK","C","47","468.18333333333","8","9","5","4","17","70.83"
"486","Tyson Jost","COL, MIN","C","80","831.51666666667","6","11","7","4","17","60.71"
"495","Taylor Raddysh","CHI, T.B","R","74","758.63333333333","7","10","8","2","17","51.52"
"504","Michael McLeod","N.J","C","77","831.9","5","12","6","6","17","58.62"
"541","Owen Tippett","FLA, PHI","R","63","724.03333333333","8","9","6","3","17","53.13"
"585","K'Andre Miller","NYR","D","82","1467.4","4","13","7","6","17","27.87"
"592","Barrett Hayton","ARI","C","60","753.35","7","10","6","4","17","56.67"
"618","Arthur Kaliyev","L.A","R","80","838.33333333333","8","9","7","2","17","50.00"
"620","Connor McMichael","WSH","C","68","696.5","8","9","7","2","17","65.38"
"51","Derick Brassard","EDM, PHI","C","46","497","7","9","5","4","16","69.57"
"82","Drew Doughty","L.A","D","39","750.95","2","14","7","7","16","45.71"
"133","Brian Dumoulin","PIT","D","76","1405.6833333333","3","13","4","9","16","23.88"
"219","Jonas Brodin","MIN","D","73","1278.8666666667","3","13","4","9","16","29.09"
"310","Adam Erne","DET","L","79","952.23333333333","5","11","7","4","16","59.26"
"317","Zach Sanford","OTT, WPG","L","80","979.53333333333","7","9","4","5","16","55.17"
"321","Jonathan Drouin","MTL","L","34","466.1","6","10","7","3","16","80.00"
"458","Mason Appleton","SEA, WPG","C","68","903.28333333333","6","10","6","4","16","50.00"
"539","Eeli Tolvanen","NSH","R","75","832.46666666667","10","6","4","2","16","53.33"
"568","Jacob Peterson","DAL","C","65","654","12","4","3","1","16","69.57"
"574","Oliver Wahlstrom","NYI","R","73","749.33333333333","8","8","6","2","16","55.17"
"580","Ryan McLeod","EDM","C","71","745","7","9","6","3","16","64.00"
"594","Adam Boqvist","CBJ","D","52","748.01666666667","8","8","3","5","16","40.00"
"596","Ty Smith","N.J","D","66","1019.5333333333","5","11","3","8","16","40.00"
"24","Alexander Edler","L.A","D","41","642.56666666667","3","12","7","5","15","48.39"
"80","Wayne Simmonds","TOR","R","72","647.95","5","10","4","6","15","65.22"
"88","Tyler Myers","VAN","D","82","1501.3333333333","1","14","8","6","15","23.81"
"115","Jakob Silfverberg","ANA","R","53","651.63333333333","4","11","6","5","15","65.22"
"189","Colin Blackwell","SEA, TOR","C","58","601.93333333333","8","7","3","4","15","75.00"
"191","Josh Manson","ANA, COL","D","67","1093.7833333333","6","9","4","5","15","39.47"
"230","Brad Hunt","VAN","D","50","700.28333333333","3","12","6","6","15","50.00"
"255","Esa Lindell","DAL","D","76","1358.6833333333","3","12","9","3","15","30.00"
"262","Jordan Martinook","CAR","L","59","623.41666666667","6","9","6","3","15","62.50"
"293","Carson Soucy","SEA","D","64","947.11666666667","9","6","3","3","15","38.46"
"334","Curtis Lazar","BOS","C","70","708.9","8","7","3","4","15","68.18"
"338","Trevor van Riemsdyk","WSH","D","72","1033.0333333333","1","14","5","9","15","35.71"
"345","Tomas Nosek","BOS","L","75","829.96666666667","3","12","7","5","15","57.69"
"373","Juho Lammikko","VAN","L","75","794.56666666667","7","8","6","2","15","57.69"
"403","Jack Eichel","VGK","C","34","515.13333333333","10","5","4","1","15","65.22"
"460","Matt Roy","L.A","D","67","1145.7833333333","2","13","10","3","15","31.25"
"478","Jakob Chychrun","ARI","D","47","854.88333333333","5","10","5","5","15","51.72"
"483","Kieffer Bellows","NYI","L","45","509.56666666667","6","9","5","4","15","68.18"
"509","Janne Kuokkanen","N.J","C, L","57","685.31666666667","4","11","4","7","15","55.56"
"511","Brandon Duhaime","MIN","R","80","748.08333333333","5","10","5","5","15","57.69"
"577","Philipp Kurashev","CHI","C","67","751.28333333333","3","12","8","4","15","71.43"
"584","Joe Veleno","DET","C","66","803.06666666667","8","7","4","3","15","65.22"
"611","Nils Hoglander","VAN","L","60","712.91666666667","9","6","2","4","15","62.50"
"615","Kaapo Kakko","NYR","R","43","569.91666666667","6","9","4","5","15","65.22"
"21","Alexander Radulov","DAL","R","71","818.86666666667","3","11","8","3","14","56.00"
"32","Marc-Edouard Vlasic","S.J","D","75","1055.8833333333","3","11","5","6","14","51.85"
"53","Nicklas Backstrom","WSH","C","47","598.45","4","10","7","3","14","56.00"
"81","Nick Holden","OTT","D","76","1222.7333333333","5","9","6","3","14","32.56"
"86","Luke Schenn","VAN","D","66","991.3","2","12","7","5","14","33.33"
"124","Zack Kassian","EDM","R","58","656.58333333333","3","11","8","3","14","46.67"
"126","Nick Leddy","DET, STL","D","75","1373.9666666667","3","11","3","8","14","28.00"
"128","Brayden McNabb","VGK","D","69","1139.1166666667","1","13","4","9","14","28.57"
"137","Chris Wideman","MTL","D","64","759.23333333333","4","10","5","5","14","53.85"
"138","Casey Cizikas","NYI","C","74","846.26666666667","9","5","3","2","14","73.68"
"139","David Savard","MTL","D","62","1078.3833333333","3","11","4","7","14","35.00"
"154","Jason Zucker","PIT","L","41","534.61666666667","5","9","5","4","14","58.33"
"170","Jaden Schwartz","SEA","C","37","549.58333333333","4","10","6","4","14","60.87"
"185","Brendan Gallagher","MTL","R","56","684.35","1","13","9","4","14","43.75"
"220","Jamie Oleksiak","SEA","D","72","1212.5","0","14","8","6","14","27.45"
"251","Radek Faksa","DAL","C","77","1009.6166666667","2","12","6","6","14","70.00"
"394","Dryden Hunt","NYR","L","76","896.8","5","9","5","4","14","58.33"
"472","Carl Grundstrom","L.A","R","54","565.23333333333","8","6","3","3","14","73.68"
"503","Nathan Bastian","N.J, SEA","R","72","692.63333333333","9","5","4","1","14","58.33"
"527","Nicolas Hague","VGK","D","52","848.33333333333","4","10","4","6","14","31.82"
"546","Morgan Frost","PHI","C","55","634.2","4","10","7","3","14","70.00"
"548","Max Comtois","ANA","L","52","626.11666666667","6","8","3","5","14","56.00"
"554","Ryan Poehling","MTL","C","57","586.33333333333","6","8","5","3","14","82.35"
"557","Alexandre Texier","CBJ","C","36","440.2","7","7","6","1","14","70.00"
"575","Martin Fehervary","WSH","D","79","1360.5833333333","6","8","5","3","14","22.95"
"586","Filip Zadina","DET","R","74","878.23333333333","6","8","4","4","14","42.42"
"604","Nico Sturm","COL, MIN","C","74","739.48333333333","5","9","4","5","14","53.85"
"636","Jamie Drysdale","ANA","D","81","1361.6166666667","3","11","7","4","14","26.42"
"2","Jason Spezza","TOR","C","71","633.31666666667","7","6","4","2","13","61.90"
"29","Marc Staal","DET","D","71","1045.9","2","11","6","5","13","23.21"
"30","T.J. Oshie","WSH","R","44","561.65","6","7","3","4","13","65.00"
"149","Radko Gudas","FLA","D","77","1189.7","2","11","6","5","13","21.67"
"165","Derek Forbort","BOS","D","76","1099.6833333333","4","9","2","7","13","31.71"
"171","Riley Sheahan","SEA","C","69","668.33333333333","4","9","5","4","13","50.00"
"203","Scott Mayfield","NYI","D","61","1020.65","3","10","6","4","13","39.39"
"244","Zemgus Girgensons","BUF","L","56","668.8","7","6","5","1","13","68.42"
"261","Chris Tierney","OTT","C","70","745.15","3","10","1","9","13","59.09"
"276","Ben Hutton","VGK","D","58","839.76666666667","3","10","6","4","13","35.14"
"283","Chad Ruhwedel","PIT","D","78","1047.1","4","9","3","6","13","27.66"
"284","Michael Raffl","DAL","L","76","930.58333333333","6","7","6","1","13","81.25"
"289","Tyler Motte","NYR, VAN","C","58","681.21666666667","5","8","5","3","13","48.15"
"326","Rasmus Ristolainen","PHI","D","66","1200.8166666667","2","11","5","6","13","24.07"
"332","Ryan Pulock","NYI","D","56","960","2","11","5","6","13","28.89"
"366","Brendan Lemieux","L.A","L","50","524.31666666667","8","5","3","2","13","56.52"
"408","Erik Cernak","T.B","D","55","856.38333333333","1","12","7","5","13","34.21"
"410","Jansen Harkins","WPG","C","77","708.5","7","6","3","3","13","76.47"
"422","Ethan Bear","CAR","D","58","823.76666666667","5","8","5","3","13","35.14"
"459","Steven Lorentz","CAR","C","67","692.93333333333","8","5","2","3","13","56.52"
"468","Ryan Lindgren","NYR","D","78","1333.2833333333","2","11","6","5","13","24.53"
"489","Jonathan Dahlen","S.J","C","61","705.25","8","5","4","1","13","56.52"
"523","Justin Danforth","CBJ","R","45","515.96666666667","10","3","2","1","13","61.90"
"524","Zach Aston-Reese","ANA, PIT","C, L","69","779.91666666667","3","10","6","4","13","50.00"
"549","Henri Jokiharju","BUF","D","60","1084.3166666667","2","11","6","5","13","30.23"
"608","Bowen Byram","COL","D","30","506.53333333333","3","10","5","5","13","46.43"
"639","Yegor Chinakhov","CBJ","R","62","677.68333333333","6","7","5","2","13","56.52"
"1","Zdeno Chara","NYI","D","72","1187.8","2","10","6","4","12","24.49"
"37","Ryan Reaves","NYR","R","69","723.66666666667","4","8","3","5","12","75.00"
"42","Nick Foligno","BOS","L","64","680.35","2","10","6","4","12","85.71"
"76","Jake Muzzin","TOR","D","47","802.78333333333","3","9","3","6","12","34.29"
"78","Carl Hagelin","WSH","L","53","638.5","2","10","4","6","12","57.14"
"114","Alex Chiasson","VAN","R","67","639.23333333333","7","5","4","1","12","44.44"
"178","Mark Pysyk","BUF","D","68","1047.6833333333","3","9","3","6","12","34.29"
"202","Mike Reilly","BOS","D","70","1160.0833333333","3","9","5","4","12","26.09"
"232","Luke Glendening","DAL","C","82","923.63333333333","9","3","1","2","12","63.16"
"260","Jimmy Vesey","N.J","L","68","802.95","5","7","3","4","12","60.00"
"380","Sam Lafferty","CHI, PIT","C, R","56","628.21666666667","5","7","6","1","12","66.67"
"400","Jonas Siegenthaler","N.J","D","70","1228.9333333333","1","11","4","7","12","22.64"
"418","Brandon Carlo","BOS","D","79","1273.7333333333","5","7","4","3","12","26.09"
"453","Dominik Simon","ANA, PIT","C","72","703.91666666667","3","9","6","3","12","46.15"
"456","Adam Gaudette","CHI, OTT","C","58","582.05","3","9","5","4","12","75.00"
"485","Andrew Peeke","CBJ","D","82","1447.5666666667","0","12","4","8","12","23.08"
"491","Logan Stanley","WPG","D","58","755.26666666667","1","11","5","6","12","46.15"
"515","Maxim Mamin","FLA","C","40","466.38333333333","5","7","4","3","12","48.00"
"528","Mario Ferraro","S.J","D","63","1188.15","2","10","3","7","12","27.27"
"564","Gustav Lindstrom","DET","D","63","917.68333333333","1","11","3","8","12","37.50"
"595","Rasmus Sandin","TOR","D","51","765.75","4","8","4","4","12","31.58"
"598","Ilya Lyubushkin","ARI, TOR","D","77","1164.4666666667","1","11","5","6","12","27.27"
"31","Andrew Cogliano","COL, S.J","C","74","779.26666666667","2","9","4","5","11","50.00"
"36","Darren Helm","COL","C","68","575.78333333333","6","5","2","3","11","68.75"
"45","Trevor Lewis","CGY","C","80","863.45","2","9","3","6","11","40.74"
"47","Cal Clutterbuck","NYI","R","59","683.58333333333","3","8","0","8","11","78.57"
"140","Nicolas Deslauriers","ANA, MIN","L","81","809.55","6","5","3","2","11","61.11"
"164","Nick Bjugstad","MIN","C","57","563.56666666667","6","5","2","3","11","57.89"
"169","Austin Watson","OTT","L","67","695.45","7","4","4","0","11","61.11"
"198","Adam Lowry","WPG","C, L","79","941.06666666667","8","3","2","1","11","57.89"
"271","Erik Gustafsson","CHI","D","59","789.76666666667","2","9","6","3","11","32.35"
"306","Michael McCarron","NSH","R","51","463.63333333333","6","5","3","2","11","55.00"
"312","Laurent Dauphin","MTL","C","38","445.71666666667","3","8","4","4","11","61.11"
"385","Dysin Mayo","ARI","D","67","1168.3","4","7","2","5","11","28.95"
"393","Matthew Highmore","VAN","C","46","518.48333333333","4","7","3","4","11","61.11"
"451","Niko Mikkola","STL","D","54","811.13333333333","2","9","6","3","11","29.73"
"544","MacKenzie Entwistle","CHI","R","55","516.6","4","7","4","3","11","73.33"
"606","Peyton Krebs","BUF, VGK","C","57","690.86666666667","7","4","4","0","11","52.38"
"640","Janis Moser","ARI","D","43","656.46666666667","3","8","5","3","11","33.33"
"40","Andy Greene","NYI","D","69","1044.6666666667","2","8","5","3","10","27.03"
"90","Michael Del Zotto","OTT","D","26","411.61666666667","2","8","3","5","10","43.48"
"96","Travis Hamonic","OTT, VAN","D","43","710.25","4","6","2","4","10","34.48"
"223","Connor Murphy","CHI","D","57","1046.5333333333","4","6","2","4","10","27.78"
"227","Colin Miller","BUF","D","38","605.31666666667","2","8","4","4","10","35.71"
"258","Devin Shore","EDM","C","49","404.8","4","6","4","2","10","66.67"
"273","Matthew Benning","NSH","D","65","885.21666666667","0","10","6","4","10","38.46"
"281","Danny DeKeyser","DET","D","59","917.15","0","10","6","4","10","35.71"
"292","Connor Clifton","BOS","D","60","867.36666666667","2","8","3","5","10","29.41"
"324","Sean Monahan","CGY","C","65","743.61666666667","3","7","5","2","10","47.62"
"339","Ryan Carpenter","CGY, CHI","C","67","679","2","8","3","5","10","62.50"
"423","Caleb Jones","CHI","D","51","783.85","4","6","3","3","10","34.48"
"446","Dean Kukan","CBJ","D","41","605.96666666667","3","7","1","6","10","31.25"
"494","Riley Stillman","CHI","D","52","705.56666666667","2","8","6","2","10","37.04"
"522","Gerry Mayhew","ANA, PHI","C","40","478.18333333333","9","1","0","1","10","62.50"
"534","Casey Mittelstadt","BUF","C","40","496.98333333333","4","6","3","3","10","55.56"
"569","Sebastian Aho","NYI","D","36","545.38333333333","2","8","1","7","10","43.48"
"599","Alexander Romanov","MTL","D","79","1355.25","3","7","2","5","10","18.18"
"628","Braden Schneider","NYR","D","43","630.73333333333","2","8","3","5","10","43.48"
"98","Marco Scandella","STL","D","70","1071.3833333333","2","7","3","4","9","17.65"
"110","Tyler Bozak","STL","C","50","513.15","2","7","3","4","9","75.00"
"183","Jani Hakanpaa","DAL","D","80","1077.5333333333","2","7","3","4","9","23.08"
"193","Dylan DeMelo","WPG","D","76","1167.6833333333","0","9","4","5","9","21.43"
"268","Dominic Toninato","WPG","C","77","522.18333333333","6","3","3","0","9","64.29"
"308","Jason Dickinson","VAN","C","62","698.46666666667","4","5","2","3","9","50.00"
"341","Patrick Brown","PHI","C","44","460.16666666667","4","5","4","1","9","64.29"
"392","Jacob Middleton","MIN, S.J","D","66","1072.1333333333","3","6","3","3","9","19.57"
"440","Gabriel Carlsson","CBJ","D","38","431.61666666667","2","7","3","4","9","39.13"
"463","Kevin Rooney","NYR","C","61","687.78333333333","5","4","2","2","9","60.00"
"512","Lucas Carlsson","FLA","D","40","497.75","3","6","3","3","9","36.00"
"518","Dylan Coghlan","VGK","D","59","746.81666666667","1","8","4","4","9","37.50"
"521","Zack MacEwen","PHI","C","75","706.91666666667","3","6","3","3","9","45.00"
"529","Cal Foote","T.B","D","56","714.33333333333","2","7","4","3","9","25.71"
"570","Sean Durzi","L.A","D","64","961.31666666667","1","8","4","4","9","24.32"
"583","Mattias Samuelsson","BUF","D","42","714.48333333333","0","9","5","4","9","28.13"
"590","Rasmus Kupari","L.A","C","57","603.68333333333","3","6","4","2","9","56.25"
"597","Karson Kuhlman","BOS, SEA","C","44","470.8","2","7","2","5","9","75.00"
"600","Jasper Weatherby","S.J","C","50","490.98333333333","4","5","3","2","9","69.23"
"635","Quinton Byfield","L.A","C","40","457.3","5","4","4","0","9","69.23"
"14","Brad Richardson","CGY, VAN","R","44","411.8","4","4","2","2","8","72.73"
"19","Andrew Ladd","ARI","L","51","587.55","4","4","1","3","8","50.00"
"34","Kris Russell","EDM","D","31","408.4","1","7","3","4","8","40.00"
"35","Keith Yandle","PHI","D","77","875.81666666667","0","8","3","5","8","33.33"
"77","Alec Martinez","VGK","D","26","450.81666666667","3","5","1","4","8","38.10"
"85","Zach Bogosian","T.B","D","48","705.06666666667","3","5","2","3","8","36.36"
"108","Antoine Roussel","ARI","L","53","538.6","4","4","4","0","8","66.67"
"141","Cody Eakin","BUF","C","69","825.5","3","5","0","5","8","40.00"
"222","Joel Armia","MTL","R","60","675.3","4","4","3","1","8","42.11"
"242","Olli Maatta","L.A","D","66","1054.0833333333","1","7","2","5","8","20.51"
"278","Jaycob Megna","S.J","D","44","734.25","2","6","3","3","8","32.00"
"387","Anders Bjork","BUF","L","58","653.81666666667","5","3","3","0","8","50.00"
"414","Christian Fischer","ARI","R","53","576.41666666667","4","4","3","1","8","72.73"
"525","Gavin Bayreuther","CBJ","D","43","535.08333333333","0","8","3","5","8","29.63"
"622","Tobias Bjornfot","L.A","D","70","1048.65","0","8","3","5","8","23.53"
"27","Jack Johnson","COL","D","74","1050.6833333333","1","6","2","4","7","18.92"
"67","Brendan Smith","CAR","D","45","571.86666666667","3","4","2","2","7","30.43"
"107","Jordie Benn","MIN","D","39","540.65","0","7","4","3","7","24.14"
"217","Sean Couturier","PHI","C","29","417.43333333333","3","4","2","2","7","46.67"
"340","Jordan Oesterle","DET","D","45","744.86666666667","1","6","4","2","7","25.00"
"376","Jake Walman","DET, STL","D","51","646.73333333333","1","6","2","4","7","36.84"
"448","Will Borgen","SEA","D","36","505.28333333333","2","5","4","1","7","50.00"
"475","Cam Dineen","ARI","D","34","470.55","0","7","3","4","7","50.00"
"488","Josh Mahura","ANA","D","38","517.48333333333","3","4","2","2","7","53.85"
"492","Boris Katchouk","CHI, T.B","L","59","543.85","3","4","2","2","7","53.85"
"508","Nikita Zaitsev","OTT","D","62","973","1","6","3","3","7","19.44"
"533","Mikey Anderson","L.A","D","57","1006.7166666667","2","5","4","1","7","16.67"
"627","Joel Kiviranta","DAL","L","56","524.16666666667","1","6","2","4","7","50.00"
"104","Matt Martin","NYI","L","71","795.15","2","4","3","1","6","27.27"
"123","Calvin de Haan","CHI","D","69","1150.6833333333","3","3","2","1","6","17.14"
"280","Andrej Sustr","ANA, T.B","D","38","512.83333333333","1","5","2","3","6","42.86"
"290","Will Butcher","BUF","D","37","564.28333333333","2","4","2","2","6","33.33"
"294","Josh Brown","BOS, OTT","D","52","634.46666666667","0","6","4","2","6","28.57"
"313","Robert Hagg","BUF, FLA","D","64","884.63333333333","0","6","3","3","6","19.35"
"383","Max Willman","PHI","C","41","461.63333333333","4","2","0","2","6","50.00"
"405","Travis Dermott","TOR, VAN","D","60","865.83333333333","1","5","2","3","6","15.79"
"429","Nicolas Meloche","S.J","D","50","765.7","2","4","1","3","6","23.08"
"430","Jeremy Lauzon","NSH, SEA","D","66","1007.8666666667","2","4","3","1","6","18.18"
"470","Julien Gauthier","NYR","R","49","477.15","2","4","2","2","6","46.15"
"480","Kale Clague","L.A, MTL","D","36","503.25","2","4","2","2","6","50.00"
"490","Victor Mete","OTT","D","37","451.11666666667","0","6","6","0","6","60.00"
"500","Henrik Borgstrom","CHI","C","52","501.68333333333","4","2","0","2","6","60.00"
"516","Casey Fitzgerald","BUF","D","36","548.73333333333","0","6","3","3","6","31.58"
"531","Jake Leschyshyn","VGK","C","41","425.91666666667","2","4","3","1","6","46.15"
"614","Cam York","PHI","D","30","454.7","2","4","2","2","6","33.33"
"160","Patrik Nemeth","NYR","D","63","923.06666666667","2","3","2","1","5","17.86"
"279","Kurtis MacDermid","COL","D","58","420.45","2","3","2","1","5","27.78"
"336","Joel Hanley","DAL","D","44","489.75","2","3","3","0","5","38.46"
"434","Kyle Capobianco","ARI","D","45","661.9","0","5","3","2","5","18.52"
"517","Dylan Gambrell","OTT","C","63","663.75","2","3","2","1","5","29.41"
"556","Erik Brannstrom","OTT","D","53","846.78333333333","0","5","3","2","5","22.73"
"602","Simon Benoit","ANA","D","53","702.25","1","4","1","3","5","20.83"
"23","Andrej Sekera","DAL","D","32","406.83333333333","1","3","1","2","4","33.33"
"66","Riley Nash","ARI, T.B, WPG","C","49","451.9","0","4","3","1","4","44.44"
"70","Robert Bortuzzo","STL","D","73","834.78333333333","1","3","0","3","4","17.39"
"157","Greg McKegg","NYR","C","43","405.38333333333","2","2","1","1","4","57.14"
"286","Kyle Burroughs","VAN","D","42","512.26666666667","1","3","1","2","4","30.77"
"295","John Hayden","BUF","C","55","554.91666666667","2","2","0","2","4","40.00"
"350","Haydn Fleury","SEA","D","36","530.88333333333","2","2","1","1","4","22.22"
"591","Ryan Merkley","S.J","D","39","523.03333333333","1","3","3","0","4","30.77"
"621","Thomas Harley","DAL","D","34","457.73333333333","1","3","2","1","4","23.53"
"103","Mark Borowiecki","NSH","D","57","632.53333333333","0","3","1","2","3","15.79"
"142","Kevin Connauton","FLA, PHI","D","39","482.36666666667","1","2","1","1","3","13.64"
"195","Nick Seeler","PHI","D","43","517.7","1","2","0","2","3","16.67"
"234","Ryan Murray","COL","D","37","469","0","3","1","2","3","17.65"
"507","Troy Stecher","DET, L.A","D","29","445.36666666667","1","2","1","1","3","23.08"
"535","Urho Vaakanainen","ANA, BOS","D","29","493.16666666667","0","3","2","1","3","13.04"
"538","Kristian Vesalainen","WPG","L","53","448.15","2","1","0","1","3","25.00"
"566","Jacob Bryson","BUF","D","73","1165.5833333333","0","3","2","1","3","6.25"
"623","Vladislav Kolyachonok","ARI","D","32","487.53333333333","1","2","2","0","3","15.79"
"291","Tucker Poolman","VAN","D","40","592.95","1","1","0","1","2","11.76"
"562","Radim Simek","S.J","D","36","457.38333333333","1","1","1","0","2","20.00"